අංස => අංශ
අංසක => අංශක
අංසද => අංශද
අංසය => අංශය
අංසයක් => අංශයක්
අංසයට => අංශයට
අංසයන් => අංශයන්
අංසයන්හි => අංශයන්හි
අංසයෙන් => අංශයෙන්
අංසයෙන්ම => අංශයෙන්ම
අංසයේ => අංශයේ
අංසවල => අංශවල
අංසවලට => අංශවලට
අංසවලටද => අංශවලටද
අංසවලින් => අංශවලින්
අංසූ => අංශූ
අක්මීමන => අක්මීමණ
අක්සර => අක්ෂර
අක්සාංශවලට => අක්ෂාංශවලට
අක්ෂාංසවලට => අක්ෂාංශවලට
අකුනු => අකුණු
අකුරන => අකුරණ
අකණ්ඩ => අඛණ්ඩ
අඛන්ඩ => අඛණ්ඩ
අකණ්ඩව => අඛණ්ඩව
අඛන්ඩව => අඛණ්ඩව
අගබාගයට => අගභාගයට
අගබාගයේ => අගභාගයේ
අගබාගයේදී => අගභාගයේදී
අගමැතිදුරයට => අගමැතිධුරයට
අගමැතිදුරයේ => අගමැතිධුරයේ
අග්රාමාත්යදූරය => අග්රාමාත්යධූරය
අග්රාමාත්යදූරයට => අග්රාමාත්යධූරයට
අගුනකොලපැලැස්සේ => අගුණකොලපැලැස්සේ
අගුනුකොලපැලැස්ස => අගුණුකොලපැලැස්ස
අගුනුගල්ලේ => අගුණුගල්ලේ
අගුලුගල්ලේ => අගුළුගල්ලේ
අටමස්තානවල => අටමස්ථානවල
අඩපන => අඩපණ
අඩපනව => අඩපණව
අඩුකල => අඩුකළ
අන => අණ
අනකරයක් => අණකරයක්
අනට => අණට
අනදෙන => අණදෙණ
අනදෙන => අණදෙණ
අනදෙන => අණදෙන
අනාවරන => අණාවරණ
අනාවරන => අණාවරණ
අනාවරනයක් => අණාවරණයක්
අනාවරනයක් => අණාවරණයක්
අනින් => අණින්
අත්නොහල => අත්නොහළ
අත්යඅවස්ය => අත්යඅවශ්ය
අත්යවසය => අත්යවශය
අත්යවස්ය => අත්යවශ්ය
අත්යාවස්ය => අත්යාවශ්ය
අත්යාවස්යව => අත්යාවශ්යව
අත්හල => අත්හළ
අතිවිසාල => අතිවිශාල
අතිවිසිෂ්ඨ => අතිවිශිෂ්ඨ
අතිවිශිස්ඨ => අතිවිශිෂ්ඨ
අතිවිසේෂ => අතිවිශේෂ
අතිවිශේස => අතිවිශේෂ
අතිවිසේෂ => අතිවිශේෂ
අතිවිශේස => අතිවිශේෂ
අතිසය => අතිශය
අතිසයින් => අතිශයින්
අතිස්ය => අතිශ්ය
අතිසාර්තකව => අතිසාර්ථකව
අතීරනයකට => අතීරණයකට
අතීසයෙන්ම => අතීශයෙන්ම
අතුල => අතුළ
අදාල => අදාළ
අදාලව => අදාළව
අදාලවයි => අදාළවයි
අද්යක්ෂ => අධ්යක්ෂ
අධ්යක්ස => අධ්යක්ෂ
අද්යක්ෂක => අධ්යක්ෂක
අධ්යක්සක => අධ්යක්ෂක
අද්යක්ෂකගේ => අධ්යක්ෂකගේ
අධ්යක්සකගේ => අධ්යක්ෂකගේ
අද්යක්ෂකවරයා => අධ්යක්ෂකවරයා
අධ්යක්සකවරයා => අධ්යක්ෂකවරයා
අද්යක්ෂකවරයාගෙන් => අධ්යක්ෂකවරයාගෙන්
අධ්යක්සකවරයාගෙන් => අධ්යක්ෂකවරයාගෙන්
අද්යක්ෂකවරයාට => අධ්යක්ෂකවරයාට
අධ්යක්සකවරයාට => අධ්යක්ෂකවරයාට
අද්යක්ෂකවරුන් => අධ්යක්ෂකවරුන්
අධ්යක්සකවරුන් => අධ්යක්ෂකවරුන්
අද්යක්ෂවරයා => අධ්යක්ෂවරයා
අධ්යක්සවරයා => අධ්යක්ෂවරයා
අද්යක්ෂවරයාට => අධ්යක්ෂවරයාට
අධ්යක්සවරයාට => අධ්යක්ෂවරයාට
අද්යක්ෂවරයාටද => අධ්යක්ෂවරයාටද
අධ්යක්සවරයාටද => අධ්යක්ෂවරයාටද
අද්යක්ෂවරයෙකු => අධ්යක්ෂවරයෙකු
අධ්යක්සවරයෙකු => අධ්යක්ෂවරයෙකු
අද්යක්ෂවරිය => අධ්යක්ෂවරිය
අධ්යක්සවරිය => අධ්යක්ෂවරිය
අද්යක්ෂවරියට => අධ්යක්ෂවරියට
අධ්යක්සවරියට => අධ්යක්ෂවරියට
අද්යක්ෂවරුන් => අධ්යක්ෂවරුන්
අධ්යක්සවරුන් => අධ්යක්ෂවරුන්
අද්යක්ෂිකා => අධ්යක්ෂිකා
අධ්යක්සිකා => අධ්යක්ෂිකා
අද්යන => අධ්යන
අද්යනය => අධ්යනය
අද්යනයකින් => අධ්යනයකින්
අද්යනයෙන් => අධ්යනයෙන්
අද්යයන => අධ්යයන
අද්යයනය => අධ්යයනය
අද්යයනයෙන් => අධ්යයනයෙන්
අද්යාත්මික => අධ්යාත්මික
අද්යාපන => අධ්යාපන
අද්යාපනඥයින් => අධ්යාපනඥයින්
අද්යාපනය => අධ්යාපනය
අද්යාපනයක් => අධ්යාපනයක්
අද්යාපනයට => අධ්යාපනයට
අද්යාපනයෙන් => අධ්යාපනයෙන්
අද්යාපනික => අධ්යාපනික
අදි => අධි
අදිආරක්ෂිත => අධිආරක්ෂිත
අධිආරක්සිත => අධිආරක්ෂිත
අදික => අධික
අදිකට => අධිකට
අදිකයි => අධිකයි
අදිකරණ => අධිකරණ
අධිකරන => අධිකරණ
අදිකරණද => අධිකරණද
අධිකරනද => අධිකරණද
අදිකරණය => අධිකරණය
අධිකරනය => අධිකරණය
අදිකරණයක => අධිකරණයක
අධිකරනයක => අධිකරණයක
අදිකරණයක් => අධිකරණයක්
අධිකරනයක් => අධිකරණයක්
අදිකරණයට => අධිකරණයට
අධිකරනයට => අධිකරණයට
අදිකරණයන් => අධිකරණයන්
අධිකරනයන් => අධිකරණයන්
අදිකරණයන්හි => අධිකරණයන්හි
අධිකරනයන්හි => අධිකරණයන්හි
අදිකරණයෙන් => අධිකරණයෙන්
අධිකරනයෙන් => අධිකරණයෙන්
අදිකරණයේ => අධිකරණයේ
අධිකරනයේ => අධිකරණයේ
අදිකරණයේදී => අධිකරණයේදී
අධිකරනයේදී => අධිකරණයේදී
අදිකරණයේදීයි => අධිකරණයේදීයි
අධිකරනයේදීයි => අධිකරණයේදීයි
අදිකරණයේ් => අධිකරණයේ්
අධිකරනයේ් => අධිකරණයේ්
අදිකරණවල => අධිකරණවල
අධිකරනවල => අධිකරණවල
අදිකරන => අධිකරන
අදිකරනය => අධිකරනය
අදිකරනයට => අධිකරනයට
අදිකරනයේදී => අධිකරනයේදී
අදිකාරි => අධිකාරි
අදිකාරිය => අධිකාරිය
අදිකාරියට => අධිකාරියට
අදිකාරියෙන් => අධිකාරියෙන්
අදිකාරියේ => අධිකාරියේ
අදිකාරිවරයාගේ => අධිකාරිවරයාගේ
අදිකාරිවරයාට => අධිකාරිවරයාට
අදිකාරිවරයාව => අධිකාරිවරයාව
අදිකාරිවරයෙක් => අධිකාරිවරයෙක්
අදිකාරිවරයෙක්ගේ => අධිකාරිවරයෙක්ගේ
අදිකාරිවරයෙකුගේ => අධිකාරිවරයෙකුගේ
අදිකාරිවරුන් => අධිකාරිවරුන්
අදිකාරී => අධිකාරී
අදිකාරීවරයා => අධිකාරීවරයා
අදිකාරීවරයාගේ => අධිකාරීවරයාගේ
අදිකාරීවරයෙක් => අධිකාරීවරයෙක්
අදිකාරීවරයෙකු => අධිකාරීවරයෙකු
අදිකාරීවරයෙකුගේ => අධිකාරීවරයෙකුගේ
අදිකාරීවරුන් => අධිකාරීවරුන්
අදිකාරීවරුන්ගේ => අධිකාරීවරුන්ගේ
අදිචෝදනා => අධිචෝදනා
අදිනීතිඥ => අධිනීතිඥ
අදිපති => අධිපති
අදිපතිවරයා => අධිපතිවරයා
අදිප්රමාණය => අධිප්රමාණය
අධිප්රමානය => අධිප්රමාණය
අදිවෙගී => අධිවෙගී
අදිවේගයේ => අධිවේගයේ
අදිවේගී => අධිවේගී
අදිෂ්ඨාන => අධිෂ්ඨාන
අධිස්ඨාන => අධිෂ්ඨාන
අදිසැර => අධිසැර
අදිසුඛෝපභෝගි => අධිසුඛෝපභෝගි
අධිසුකෝපභෝගි => අධිසුඛෝපභෝගි
අධිසුඛෝපබෝගි => අධිසුඛෝපභෝගි
අදිිකරණයට => අධිිකරණයට
අධිිකරනයට => අධිිකරණයට
අදීකරණයට => අධීකරණයට
අධීකරනයට => අධීකරණයට
අදීක්ෂණ => අධීක්ෂණ
අධීක්සණ => අධීක්ෂණ
අධීක්ෂන => අධීක්ෂණ
අදීක්ෂණය => අධීක්ෂණය
අධීක්සණය => අධීක්ෂණය
අධීක්ෂනය => අධීක්ෂණය
අදීක්ෂණයට => අධීක්ෂණයට
අධීක්සණයට => අධීක්ෂණයට
අධීක්ෂනයට => අධීක්ෂණයට
අදීකාරිවරයෙකු => අධීකාරිවරයෙකු
අදෛර්ය => අධෛර්ය
අනද්යන => අනධ්යන
අනපේක්සිත => අනපේක්ෂිත
අනවබෝදයක් => අනවබෝධයක්
අනවබෝදයන් => අනවබෝධයන්
අනවස්ය => අනවශ්ය
අනාරක්සිත => අනාරක්ෂිත
අනාරක්සිතව => අනාරක්ෂිතව
අනාරවන => අනාරවණ
අනාරවරනයක් => අනාරවරණයක්
අනාවරන => අනාවරණ
අනාවරනය => අනාවරණය
අනාවරනයක් => අනාවරණයක්
අනාවරනයන් => අනාවරණයන්
අනාවරනයවි => අනාවරණයවි
අනාවරනයෙන් => අනාවරණයෙන්
අනාවරනවීම => අනාවරණවීම
අනාවැකිකරන => අනාවැකිකරණ
අනුබද්ද => අනුබද්ධ
අනුබව => අනුභව
අනුබවය => අනුභවය
අනුබවයටත් => අනුභවයටත්
අනුබවයේදී => අනුභවයේදී
අනුරාදපුර => අනුරාධපුර
අනුරාදපුරය => අනුරාධපුරය
අනුරාදපුරයට => අනුරාධපුරයට
අනුරාදපුරයේ => අනුරාධපුරයේ
අනුරාදපුරයේදී => අනුරාධපුරයේදී
අනුරුද්ද => අනුරුද්ධ
අනුසාසක => අනුශාසක
අනුසාසනා => අනුශාසනා
අනුස්ක => අනුෂ්ක
අනුස්කා => අනුෂ්කා
අනුස්මරන => අනුස්මරණ
අනුස්මරනය => අනුස්මරණය
අනුස්මරනයෙහි => අනුස්මරණයෙහි
අනූසා => අනූෂා
අපක්සපාතී => අපක්ෂපාතී
අපක්සපාතීව => අපක්ෂපාතීව
අපරබාග => අපරභාග
අපරාද => අපරාධ
අපරාදකරුවන් => අපරාධකරුවන්
අපරාදකරුවන්ගේ => අපරාධකරුවන්ගේ
අපරාදකරුවෙක් => අපරාධකරුවෙක්
අපරාදකරුවෙකු => අපරාධකරුවෙකු
අපරාදය => අපරාධය
අපරාදයක් => අපරාධයක්
අපරාදයට => අපරාධයට
අපරාදවලට => අපරාධවලට
අපරාදවලින් => අපරාධවලින්
අපාරාද => අපාරාධ
අපේක්සකත්වයට => අපේක්ෂකත්වයට
අපේක්සිතයි => අපේක්ෂිතයි
අපේක්සක => අපේක්ෂක
අපේක්සකත්වය => අපේක්ෂකත්වය
අපේක්සකත්වයට => අපේක්ෂකත්වයට
අපේක්සකයකු => අපේක්ෂකයකු
අපේක්සකයන් => අපේක්ෂකයන්
අපේක්සකයයි => අපේක්ෂකයයි
අපේක්සකයා => අපේක්ෂකයා
අපේක්සකයාට => අපේක්ෂකයාට
අපේක්සකයින් => අපේක්ෂකයින්
අපේක්සකයෙක් => අපේක්ෂකයෙක්
අපේක්සකයෙකු => අපේක්ෂකයෙකු
අපේක්සකයෙකුට => අපේක්ෂකයෙකුට
අපේක්සකයෙකුයි => අපේක්ෂකයෙකුයි
අපේක්සයාට => අපේක්ෂයාට
අපේක්සා => අපේක්ෂා
අපේක්සාවක් => අපේක්ෂාවක්
අපේක්සාවන් => අපේක්ෂාවන්
අපේක්සාවයි => අපේක්ෂාවයි
අපේක්සාවෙන් => අපේක්ෂාවෙන්
අපේක්සිකාවක් => අපේක්ෂිකාවක්
අපේක්සිත => අපේක්ෂිත
අපේක්සිතයි => අපේක්ෂිතයි
අපේස්කයෙකුට => අපේෂ්කයෙකුට
අබාදයකට => අබාධයකට
අබාදිත => අබාධිත
අබේගුනවර්ධන => අබේගුණවර්ධන
අබේගුණවර්දන => අබේගුණවර්ධන
අබේරවර්දන => අබේරවර්ධන
අබේවර්දන => අබේවර්ධන
අබේවර්දනගේ => අබේවර්ධනගේ
අබේසිරිගුනවර්ධන => අබේසිරිගුණවර්ධන
අබේසිරිගුණවර්දන => අබේසිරිගුණවර්ධන
අබයතිස්ස => අභයතිස්ස
අබයසේකරරාම => අභයසේකරරාම
අබයාවකාශ => අභයාවකාශ
අභයාවකාස => අභයාවකාශ
අබවප්රාප්ත => අභවප්රාප්ත
අබ්යන්තර => අභ්යන්තර
අබ්යන්තරයේ => අභ්යන්තරයේ
අබ්යවකාශ => අභ්යවකාශ
අභ්යවකාස => අභ්යවකාශ
අබ්යවකාශයට => අභ්යවකාශයට
අභ්යවකාසයට => අභ්යවකාශයට
අබ්යවකාශයේදී => අභ්යවකාශයේදී
අභ්යවකාසයේදී => අභ්යවකාශයේදී
අබ්යාස => අභ්යාස
අබාවප්රාප්ත => අභාවප්රාප්ත
අබාවප්රාප්තවී => අභාවප්රාප්තවී
අබාවප්රාප්තවු => අභාවප්රාප්තවු
අබාවප්රාප්තවූ => අභාවප්රාප්තවූ
අබිනන්දන් => අභිනන්දන්
අබිනව => අභිනව
අබිබවා => අභිභවා
අබිබවා => අභිභවා
අබිමතය => අභිමතය
අබිමානය => අභිමානය
අබියස => අභියස
අබියසටම => අභියසටම
අබියසදී => අභියසදී
අබියසදීය => අභියසදීය
අබියාචන => අභියාචන
අබියාචනය => අභියාචනය
අබියාචනයක් => අභියාචනයක්
අබියාචනයන් => අභියාචනයන්
අබියාචනාධිකරණ => අභියාචනාධිකරණ
අභියාචනාදිකරණ => අභියාචනාධිකරණ
අභියාචනාධිකරන => අභියාචනාධිකරණ
අබියාචනාධිකරණය => අභියාචනාධිකරණය
අභියාචනාදිකරණය => අභියාචනාධිකරණය
අභියාචනාධිකරනය => අභියාචනාධිකරණය
අබියාචනාධිකරණයට => අභියාචනාධිකරණයට
අභියාචනාදිකරණයට => අභියාචනාධිකරණයට
අභියාචනාධිකරනයට => අභියාචනාධිකරණයට
අබියාචනාධිකරණයෙන් => අභියාචනාධිකරණයෙන්
අභියාචනාදිකරණයෙන් => අභියාචනාධිකරණයෙන්
අභියාචනාධිකරනයෙන් => අභියාචනාධිකරණයෙන්
අබියාචනාධිකරණයේ => අභියාචනාධිකරණයේ
අභියාචනාදිකරණයේ => අභියාචනාධිකරණයේ
අභියාචනාධිකරනයේ => අභියාචනාධිකරණයේ
අබියාචනාධිකරණයේදී => අභියාචනාධිකරණයේදී
අභියාචනාදිකරණයේදී => අභියාචනාධිකරණයේදී
අභියාචනාධිකරනයේදී => අභියාචනාධිකරණයේදී
අබියෝග => අභියෝග
අබියෝගය => අභියෝගය
අබියෝගයකට => අභියෝගයකට
අබියෝගයක් => අභියෝගයක්
අබියෝගයට => අභියෝගයට
අබියෝගයන්ටද => අභියෝගයන්ටද
අබිලාෂ => අභිලාෂ
අභිලාස => අභිලාෂ
අබීත => අභීත
අමරනීය => අමරණීය
අමරවංස => අමරවංශ
අමාතදුරයන් => අමාතධුරයන්
අමාතයදුරයන් => අමාතයධුරයන්
අමාත්යංස => අමාත්යංශ
අමාත්යංසය => අමාත්යංශය
අමාත්යංසයට => අමාත්යංශයට
අමාත්යංසයන්හි => අමාත්යංශයන්හි
අමාත්යංසයෙන් => අමාත්යංශයෙන්
අමාත්යංසයේ => අමාත්යංශයේ
අමාත්යංසයේත් => අමාත්යංශයේත්
අමාත්යංසයේදීයි => අමාත්යංශයේදීයි
අමාත්යංසවල => අමාත්යංශවල
අමාත්යංස්ය => අමාත්යංශ්ය
අමාත්යදුර => අමාත්යධුර
අමාත්යදුරය => අමාත්යධුරය
අමාත්යදුරයන් => අමාත්යධුරයන්
අමාත්යදුරයෙන් => අමාත්යධුරයෙන්
අමාත්යදූර => අමාත්යධූර
අමාත්යදූරය => අමාත්යධූරය
අමාත්යදූරයක => අමාත්යධූරයක
අමාත්යදූරයක් => අමාත්යධූරයක්
අමාත්යදූරයට => අමාත්යධූරයට
අමාත්යදූරයෙන් => අමාත්යධූරයෙන්
අමාත්යදූරයේ => අමාත්යධූරයේ
අමාත්යදූරවලින් => අමාත්යධූරවලින්
අමාත්යාංස => අමාත්යාංශ
අමාත්යාංසය => අමාත්යාංශය
අමාත්යාංසයක => අමාත්යාංශයක
අමාත්යාංසයක් => අමාත්යාංශයක්
අමාත්යාංසයට => අමාත්යාංශයට
අමාත්යාංසයටද => අමාත්යාංශයටද
අමාත්යාංසයත් => අමාත්යාංශයත්
අමාත්යාංසයද => අමාත්යාංශයද
අමාත්යාංසයන්හි => අමාත්යාංශයන්හි
අමාත්යාංසයි => අමාත්යාංශයි
අමාත්යාංසයෙන් => අමාත්යාංශයෙන්
අමාත්යාංසයෙන්ද => අමාත්යාංශයෙන්ද
අමාත්යාංසයේ => අමාත්යාංශයේ
අමාත්යාංසයේදී => අමාත්යාංශයේදී
අමාත්යාංසවල => අමාත්යාංශවල
අමාත්යාංසවලට => අමාත්යාංශවලට
අමාත්යාසය => අමාත්යාශය
අමාත්යාසවලම => අමාත්යාශවලම
අමානුසික => අමානුෂික
අමුන => අමුණ
අමුනා => අමුණා
අමුනුගම => අමුණුගම
අමුනුගමද => අමුණුගමද
අමුනුමගම => අමුණුමගම
අබ => අඹ
අබගස්දෝව => අඹගස්දෝව
අබතලේ => අඹතලේ
අබන්පෝරුව => අඹන්පෝරුව
අබු => අඹු
අබුසැමි => අඹුසැමි
අයවලුන් => අයවළුන්
අයවලුන්ය => අයවළුන්ය
අරක්සක => අරක්ෂක
අරම්බ => අරම්භ
අරමුන => අරමුණ
අරමුනක් => අරමුණක්
අරමුනකින් => අරමුණකින්
අරමුනයි => අරමුණයි
අරමුනින් => අරමුණින්
අරමුනින්දැයි => අරමුණින්දැයි
අරමුනු => අරමුණු
අරමුනුවලට => අරමුණුවලට
අරමුනෙන් => අරමුණෙන්
අරබන => අරඹන
අරබන්න => අරඹන්න
අරබයි => අරඹයි
අරබා => අරඹා
අර්ජුන => අර්ජුණ
අර්ජුනගෙන් => අර්ජුණගෙන්
අර්ත => අර්ථ
අර්තකතන => අර්ථකතන
අර්තකතනය => අර්ථකතනය
අර්තසාධකය => අර්ථසාධකය
අර්ථසාදකය => අර්ථසාධකය
අර්ද => අර්ධ
අර්බුදකාරී => අර්බුධකාරී
අර්බුදය => අර්බුධය
අර්බුදයකට => අර්බුධයකට
අර්බුදයක් => අර්බුධයක්
අර්බුදයෙන් => අර්බුධයෙන්
අරාබිකරනයකට => අරාබිකරණයකට
අලකොලදෙනිය => අලකොලදෙණිය
අලපලාදෙනිය => අලපලාදෙණිය
අල්කාස්මිරි => අල්කාශ්මිරි
අල්හස්මි => අල්හෂ්මි
අලාබ => අලාභ
අලාබය => අලාභය
අලාබයන් => අලාභයන්
අවංකබාවයෙන් => අවංකභාවයෙන්
අවකාස => අවකාශ
අවකාසය => අවකාශය
අවකාසයන් => අවකාශයන්
අවතීරන => අවතීරණ
අවතීර්න => අවතීර්ණ
අවදානම => අවධානම
අවදානමක => අවධානමක
අවදානමක් => අවධානමක්
අවදානමට => අවධානමට
අවදානම් => අවධානම්
අවදානය => අවධානය
අවදානයක් => අවධානයක්
අවදානයකින් => අවධානයකින්
අවදානයට => අවධානයට
අවදානයෙන් => අවධානයෙන්
අවදාරණය => අවධාරණය
අවධාරනය => අවධාරණය
අවදියෙන් => අවධියෙන්
අවදියේදී => අවධියේදී
අවප්රමානය => අවප්රමාණය
අවප්රමානයවීම => අවප්රමාණයවීම
අවබෝද => අවබෝධ
අවබෝදයක් => අවබෝධයක්
අවබෝදයකින් => අවබෝධයකින්
අවබෝදයෙන් => අවබෝධයෙන්
අවබාවිත => අවභාවිත
අවබාවිතයන් => අවභාවිතයන්
අවස්ය => අවශ්ය
අවස්යතා => අවශ්යතා
අවස්යතාව => අවශ්යතාව
අවස්යතාවක් => අවශ්යතාවක්
අවස්යතාවද => අවශ්යතාවද
අවස්යතාවන් => අවශ්යතාවන්
අවස්යතාවය => අවශ්යතාවය
අවස්යතාවයක් => අවශ්යතාවයක්
අවස්යතාවයන් => අවශ්යතාවයන්
අවස්යය => අවශ්යය
අවස්යයි => අවශ්යයි
අවස්යව => අවශ්යව
අවස්යවී => අවශ්යවී
අවස්යවුවහොත් => අවශ්යවුවහොත්
අවස්තා => අවස්ථා
අවස්තාව => අවස්ථාව
අවස්තාවක => අවස්ථාවක
අවස්තාවකට => අවස්ථාවකට
අවස්තාවකදි => අවස්ථාවකදි
අවස්තාවකදී => අවස්ථාවකදී
අවස්තාවක් => අවස්ථාවක්
අවස්තාවක්ද => අවස්ථාවක්ද
අවස්තාවට => අවස්ථාවට
අවස්තාවද => අවස්ථාවද
අවස්තාවන් => අවස්ථාවන්
අවස්තාවන්ට => අවස්ථාවන්ට
අවස්තාවන්වලදී => අවස්ථාවන්වලදී
අවස්තාවන්හිදි => අවස්ථාවන්හිදි
අවස්තාවන්හිදී => අවස්ථාවන්හිදී
අවස්තාවයි => අවස්ථාවයි
අවස්තාවල => අවස්ථාවල
අවස්තාවලදි => අවස්ථාවලදි
අවස්තාවලදී => අවස්ථාවලදී
අවස්තාවාදී => අවස්ථාවාදී
අවස්තාවෙන් => අවස්ථාවෙන්
අවස්තාවේ => අවස්ථාවේ
අවස්තාවේදි => අවස්ථාවේදි
අවස්තාවේදිය => අවස්ථාවේදිය
අවස්තාවේදී => අවස්ථාවේදී
අවස්තාවේදීම => අවස්ථාවේදීම
අවස්තාවේදීය => අවස්ථාවේදීය
අවස්තාවේදීයි => අවස්ථාවේදීයි
අවස්තාවේම => අවස්ථාවේම
අවස්තාවේයි => අවස්ථාවේයි
අවාරනය => අවාරණය
අවිආයුද => අවිආයුධ
අවිදිමත් => අවිධිමත්
අවිදිමත්ව => අවිධිමත්ව
අවිනිස්චිත => අවිනිශ්චිත
අවිනිස්චිතතාවයක් => අවිනිශ්චිතතාවයක්
අවිනිස්චිතයි => අවිනිශ්චිතයි
අවිස්ක => අවිශ්ක
අවිස්වාසය => අවිශ්වාසය
අවිස්වාසයක් => අවිශ්වාසයක්
අවිස්වාසයෙන් => අවිශ්වාසයෙන්
අවිස්වාසයේ => අවිශ්වාසයේ
අවිස්ක => අවිෂ්ක
අවුලුවාලන => අවුළුවාලන
අස්රෆ් => අශ්රෆ්
අස්රිතව => අශ්රිතව
අස්වින් => අශ්වින්
අසොක් => අශොක්
අසෝක => අශෝක
අසෝක් => අශෝක්
අසෝකා => අශෝකා
අසෝභන => අශෝභන
අශෝබන => අශෝභන
අස්කාන් => අෂ්කාන්
අස්ඨාංග => අෂ්ඨාංග
අස්රොෆ් => අෂ්රොෆ්
අසබ්ය => අසභ්ය
අසරන => අසරණ
අසරනයන් => අසරණයන්
අසල => අසළ
අසලදී => අසළදී
අසලින් => අසළින්
අස්තාන => අස්ථාන
අස්තාව => අස්ථාව
අස්තාවර => අස්ථාවර
අස්තාවරත්වය => අස්ථාවරත්වය
අස්තාවරත්වයක් => අස්ථාවරත්වයක්
අස්තාවරත්වයට => අස්ථාවරත්වයට
අස්ති => අස්ථි
අස්තී => අස්ථී
අස්නොවුනහොත් => අස්නොවුණහොත්
අස්වුනා => අස්වුණා
අස්වුනේ => අස්වුණේ
අසාද්ය => අසාධ්ය
අසාදාරණ => අසාධාරණ
අසාධාරන => අසාධාරණ
අසාදාරණයක් => අසාධාරණයක්
අසාධාරනයක් => අසාධාරණයක්
අසාදාරණයට => අසාධාරණයට
අසාධාරනයට => අසාධාරණයට
අසාර්තක => අසාර්ථක
අසාර්තකත්වයට => අසාර්ථකත්වයට
අසාර්තකයි => අසාර්ථකයි
අසාර්තකවීම => අසාර්ථකවීම
අහබු => අහඹු
අලලා => අළලා
අලුත් => අළුත්
අලුත්ගම => අළුත්ගම
අලුත්වැඩියා => අළුත්වැඩියා
අලුයම => අළුයම
අලුයමදි => අළුයමදි
අලුයම් => අළුයම්
අලෙවි => අළෙවි
අලෙවිකරණ => අළෙවිකරණ
අළෙවිකරන => අළෙවිකරණ
ආංසික => ආංශික
ආකර්සනයක් => ආකර්ශනයක්
ආකර්සනීයම => ආකර්ශනීයම
ආක්රමනය => ආක්රමණය
ආක්රමනශීලී => ආක්රමණශීලී
ආක්රමණසීලී => ආක්රමණශීලී
ආන්ඩු => ආණ්ඩු
ආන්ඩුකම => ආණ්ඩුකම
ආන්ඩුකර => ආණ්ඩුකර
ආන්ඩුකරනය => ආණ්ඩුකරණය
ආන්ඩුකරනය => ආණ්ඩුකරණය
ආන්ඩුක්රම => ආණ්ඩුක්රම
ආන්ඩුකාර => ආණ්ඩුකාර
ආන්ඩුකාරධුරයෙන් => ආණ්ඩුකාරධුරයෙන්
ආණ්ඩුකාරදුරයෙන් => ආණ්ඩුකාරධුරයෙන්
ආන්ඩුකාරවරයා => ආණ්ඩුකාරවරයා
ආන්ඩුකාරවරයාගේ => ආණ්ඩුකාරවරයාගේ
ආන්ඩුකාරවරයාට => ආණ්ඩුකාරවරයාට
ආන්ඩුකාරවරයෙකු => ආණ්ඩුකාරවරයෙකු
ආන්ඩුකාරවරයෙකුට => ආණ්ඩුකාරවරයෙකුට
ආන්ඩුකාරවරු => ආණ්ඩුකාරවරු
ආන්ඩුකාරවරුන් => ආණ්ඩුකාරවරුන්
ආන්ඩුකාරවරුන්ට => ආණ්ඩුකාරවරුන්ට
ආන්ඩුකාරවුරුන් => ආණ්ඩුකාරවුරුන්
ආන්ඩුව => ආණ්ඩුව
ආන්ඩුවක => ආණ්ඩුවක
ආන්ඩුවකට => ආණ්ඩුවකට
ආන්ඩුවකදී => ආණ්ඩුවකදී
ආන්ඩුවක් => ආණ්ඩුවක්
ආන්ඩුවට => ආණ්ඩුවට
ආන්ඩුවටත් => ආණ්ඩුවටත්
ආන්ඩුවටම => ආණ්ඩුවටම
ආන්ඩුවෙන් => ආණ්ඩුවෙන්
ආන්ඩුවෙන්ම => ආණ්ඩුවෙන්ම
ආන්ඩුවේ => ආණ්ඩුවේ
ආන්ඩුවේම => ආණ්ඩුවේම
ආදර්ස => ආදර්ශ
ආදර්සය => ආදර්ශය
ආදර්සයක් => ආදර්ශයක්
ආදාල => ආදාළ
ආදේස => ආදේශ
ආදේසක => ආදේශක
ආදාර => ආධාර
ආදාරකරුවන් => ආධාරකරුවන්
ආදාරකරුවෙක් => ආධාරකරුවෙක්
ආදාරකරුවෙකු => ආධාරකරුවෙකු
ආදාරයක් => ආධාරයක්
ආදාරයෙන් => ආධාරයෙන්
ආදුනික => ආධුනික
ආදුනිකයෙක් => ආධුනිකයෙක්
ආබාදයකට => ආබාධයකට
ආබාදයක් => ආබාධයක්
ආබාදයට => ආබාධයට
ආබාදිත => ආබාධිත
ආමන්ත්රනය => ආමන්ත්රණය
ආයුද => ආයුධ
ආයුදයක් => ආයුධයක්
ආයුදයක්ද => ආයුධයක්ද
ආයුදයට => ආයුධයට
ආයුදවලින් => ආයුධවලින්
ආරක්ස => ආරක්ෂ
ආරක්සක => ආරක්ෂක
ආරක්සකයින් => ආරක්ෂකයින්
ආරක්සණ => ආරක්ෂණ
ආරක්ෂන => ආරක්ෂණ
ආරක්සව => ආරක්ෂව
ආරක්සා => ආරක්ෂා
ආරක්සාක => ආරක්ෂාක
ආරක්සාකාරී => ආරක්ෂාකාරී
ආරක්සාව => ආරක්ෂාව
ආරක්සාවක් => ආරක්ෂාවක්
ආරක්සාවට => ආරක්ෂාවට
ආරක්සාවටද => ආරක්ෂාවටද
ආරක්සාවත් => ආරක්ෂාවත්
ආරක්සාවයි => ආරක්ෂාවයි
ආරක්සාවේ => ආරක්ෂාවේ
ආරක්සිත => ආරක්ෂිත
ආරක්සිතව => ආරක්ෂිතව
ආරන්ය => ආරණ්ය
ආරම්බ => ආරම්භ
ආරම්බක => ආරම්භක
ආරම්බකර => ආරම්භකර
ආරම්බය => ආරම්භය
ආරම්බයක් => ආරම්භයක්
ආරම්බයට => ආරම්භයට
ආරම්බයේ => ආරම්භයේ
ආරම්බයේදී => ආරම්භයේදී
ආරම්බවී => ආරම්භවී
ආරම්බවීමට => ආරම්භවීමට
ආරම්බවීමෙන් => ආරම්භවීමෙන්
ආරම්බවූ => ආරම්භවූ
ආර්තික => ආර්ථික
ආර්තිකමය => ආර්ථිකමය
ආර්තිකය => ආර්ථිකය
ආර්තිකයක් => ආර්ථිකයක්
ආර්තිකයට => ආර්ථිකයට
ආර්තිකයටද => ආර්ථිකයටද
ආර්තිකයේ => ආර්ථිකයේ
ආර්තීක => ආර්ථීක
ආර්සම්බන්දන් => ආර්සම්බන්ධන්
ආරාදනයකට => ආරාධනයකට
ආරාදනයක් => ආරාධනයක්
ආරාදනයෙන් => ආරාධනයෙන්
ආරාදනා => ආරාධනා
ආරාදනාවකට => ආරාධනාවකට
ආරාදනාවක් => ආරාධනාවක්
ආරාදනාවෙන් => ආරාධනාවෙන්
ආරාදිත => ආරාධිත
ආරාදිනගර් => ආරාධිනගර්
ආවරන => ආවරණ
ආවරනය => ආවරණය
ආවරනයක => ආවරණයක
ආවරනයකින් => ආවරණයකින්
ආවරනයට => ආවරණයට
ආවරනයේ => ආවරණයේ
ආස්රිත => ආශ්රිත
ආස්රිතව => ආශ්රිතව
ආස්රිතවද => ආශ්රිතවද
ආස්රීතව => ආශ්රීතව
ආසාවන්ගෙන් => ආශාවන්ගෙන්
ආසිර්වාද => ආශිර්වාද
ආසිර්වාදය => ආශිර්වාදය
ආසිර්වාදයක් => ආශිර්වාදයක්
ආසිර්වාදයෙන් => ආශිර්වාදයෙන්
ආසි්රත => ආශි්රත
ආසි්රතව => ආශි්රතව
ආසීර්වාදය => ආශීර්වාදය
ආසී්රතව => ආශී්රතව
ආසු => ආශු
ආසූ => ආශූ
ආසාදන => ආසාධන
ආසාදාරණයක් => ආසාධාරණයක්
ආසාධාරනයක් => ආසාධාරණයක්
ඇගලුම් => ඇගළුම්
ඇන => ඇණ
ඇනවුම් => ඇණවුම්
ඇනවුම්ද => ඇණවුම්ද
ඇනුම් => ඇණුම්
ඇතිවුනා => ඇතිවුණා
ඇතුලට => ඇතුළට
ඇතුලත => ඇතුළත
ඇතුලත් => ඇතුළත්
ඇතුලත්කර => ඇතුළත්කර
ඇතුලත්ව => ඇතුළත්ව
ඇතුලු => ඇතුළු
ඇතුලුත් => ඇතුළුත්
ඇතුලුව => ඇතුළුව
ඇතුලුවන => ඇතුළුවන
ඇතුලුවි => ඇතුළුවි
ඇතුලුවිම => ඇතුළුවිම
ඇතුලුවී => ඇතුළුවී
ඇතුලුවීම => ඇතුළුවීම
ඇතුලුවීමට => ඇතුළුවීමට
ඇතුලුවීමේදී => ඇතුළුවීමේදී
ඇතුලේ => ඇතුළේ
ඇදහැලුණා => ඇදහැළුණා
ඇදහැළුනා => ඇදහැළුණා
ඇදහැලුණු => ඇදහැළුණු
ඇදහැළුනු => ඇදහැළුණු
ඇදහැලෙනු => ඇදහැළෙනු
ඇමතිදුර => ඇමතිධුර
ඇමතිදුරය => ඇමතිධුරය
ඇමතිදූර => ඇමතිධූර
ඇමතිදූරය => ඇමතිධූරය
ඇමතිදූරවලින් => ඇමතිධූරවලින්
ඇමැතිදුරයෙන් => ඇමැතිධුරයෙන්
ඇමැතිදූරයෙන් => ඇමැතිධූරයෙන්
ඇබව => ඇඹව
ඇබිලිපිටිය => ඇඹිලිපිටිය
ඇබිලිපිටියට => ඇඹිලිපිටියට
ඇබිලිපිටියේ => ඇඹිලිපිටියේ
ඇබිළිපිටියේදී => ඇඹිළිපිටියේදී
ඇඹිලිපිටියේදී => ඇඹිළිපිටියේදී
ඇරබි => ඇරඹි
ඇරබිම => ඇරඹිම
ඇරබීම => ඇරඹීම
ඇරබීමට => ඇරඹීමට
ඇරබීමේ => ඇරඹීමේ
ඇරබෙයි => ඇරඹෙයි
ඇරබේ => ඇරඹේ
ඇසල => ඇසළ
ඇසුනු => ඇසුණු
ඇල => ඇළ
ඇෆ්ගනිස්තාන => ඇෆ්ගනිස්ථාන
ඇෆ්ගනිස්තානය => ඇෆ්ගනිස්ථානය
ඇෆ්ගනිස්තානයට => ඇෆ්ගනිස්ථානයට
ඇෆ්ගනිස්තානයේ => ඇෆ්ගනිස්ථානයේ
ඇෆ්ගනිස්තානයේදී => ඇෆ්ගනිස්ථානයේදී
ඇෆ්ග්ගනිස්තානයට => ඇෆ්ග්ගනිස්ථානයට
ඇෆ්ග්ගනිස්තානයේ => ඇෆ්ග්ගනිස්ථානයේ
ඈස්ලි => ඈෂ්ලි
ඈස්වුඞ්හිදීයි => ඈෂ්වුඞ්හිදීයි
ඉක්මනින් => ඉක්මණින්
ඉටුකල => ඉටුකළ
ඉනිම => ඉණිම
ඉනිමක => ඉණිමක
ඉනිමක් => ඉණිමක්
ඉනිමට => ඉණිමට
ඉදිකල => ඉදිකළ
ඉදිකෙරුනු => ඉදිකෙරුණු
ඉදිරිපත්කල => ඉදිරිපත්කළ
ඉදිරිපෙල => ඉදිරිපෙළ
ඉන්ටර්නැසනල් => ඉන්ටර්නැෂනල්
ඉන්දුස්රී => ඉන්දුශ්රී
ඉන්දන => ඉන්ධන
ඉන්සා => ඉන්ෂා
ඉන්සාෆ් => ඉන්ෂාෆ්
ඉන්සාෆ්ට => ඉන්ෂාෆ්ට
ඉපැරනි => ඉපැරණි
ඉමේස් => ඉමේෂ්
ඉබුලාන => ඉඹුලාන
ඉරනම => ඉරණම
ඉරනමක් => ඉරණමක්
ඉරනම් => ඉරණම්
ඉර්සාඩ් => ඉර්ෂාඩ්
ඉර්සාන් => ඉර්ෂාන්
ඉස්ට => ඉෂ්ට
ඉසාරා => ඉෂාරා
ඉහල => ඉහළ
ඉහලට => ඉහළට
ඉහලපෙලේ => ඉහළපෙලේ
ඉහලම => ඉහළම
ඉහලයාම => ඉහළයාම
ඉහලයාමක් => ඉහළයාමක්
ඉහලාගෙන => ඉහළාගෙන
ඉහලින් => ඉහළින්
ඊස්රායල => ඊශ්රායල
ඊස්රායලය => ඊශ්රායලය
ඊස්රායලයද => ඊශ්රායලයද
ඊස්රායලයේ => ඊශ්රායලයේ
ඊස්රායල් => ඊශ්රායල්
ඊලඟ => ඊළඟ
ඊලඟට => ඊළඟට
ඊලාම් => ඊළාම්
උගත්තරුන => උගත්තරුණ
උච්චාරණය => උච්ඡාරණය
උච්ඡාරනය => උච්ඡාරණය
උනගස්වල => උණගස්වල
උන්ඩ => උණ්ඩ
උන්ඩයක් => උණ්ඩයක්
උන්ඩවලට => උණ්ඩවලට
උනු => උණු
උනුදිය => උණුදිය
උනුවටුන => උණුවටුන
උනුසම් => උණුසම්
උනුසුම => උණුසුම
උනුසුමක් => උණුසුමක්
උනුසුම් => උණුසුම්
උනුසුම්කාරී => උණුසුම්කාරී
උනූසුම් => උණූසුම්
උත්කර්සවත් => උත්කර්ෂවත්
උත්කෘස්ඨ => උත්කෘෂ්ඨ
උද්ගෝෂකයන් => උද්ඝෝෂකයන්
උද්ඝෝසකයන් => උද්ඝෝෂකයන්
උද්ගෝෂකයින් => උද්ඝෝෂකයින්
උද්ඝෝසකයින් => උද්ඝෝෂකයින්
උද්ගෝෂණ => උද්ඝෝෂණ
උද්ඝෝසණ => උද්ඝෝෂණ
උද්ඝෝෂන => උද්ඝෝෂණ
උද්ගෝෂණය => උද්ඝෝෂණය
උද්ඝෝසණය => උද්ඝෝෂණය
උද්ඝෝෂනය => උද්ඝෝෂණය
උද්ගෝෂණයක => උද්ඝෝෂණයක
උද්ඝෝසණයක => උද්ඝෝෂණයක
උද්ඝෝෂනයක => උද්ඝෝෂණයක
උද්ගෝෂණයක් => උද්ඝෝෂණයක්
උද්ඝෝසණයක් => උද්ඝෝෂණයක්
උද්ඝෝෂනයක් => උද්ඝෝෂණයක්
උදාවුනා => උදාවුණා
උදාවුනේ => උදාවුණේ
උදාහරනය => උදාහරණය
උදාහරනයක් => උදාහරණයක්
උපකරන => උපකරණ
උපකරනය => උපකරණය
උපකරනයක් => උපකරණයක්
උපදේසක => උපදේශක
උපදේසකයන් => උපදේශකයන්
උපදේසකයින් => උපදේශකයින්
උපදේසකයින්ට => උපදේශකයින්ට
උපදේසකයෙක් => උපදේශකයෙක්
උපදේසකයෙකු => උපදේශකයෙකු
උපදේසකවරයා => උපදේශකවරයා
උපදේසකවරයෙකු => උපදේශකවරයෙකු
උපදේසන => උපදේශන
උපදිදාරීන් => උපධිධාරීන්
උපදිදාරීන් => උපධිධාරීන්
උපරිමාදිකරණ => උපරිමාධිකරණ
උපරිමාධිකරන => උපරිමාධිකරණ
උපසබාපති => උපසභාපති
උපාදි => උපාධි
උපාදිදාරියෙක් => උපාධිදාරියෙක්
උපාදිදාරීන් => උපාධිදාරීන්
උපාදිදාරිනියක්ද => උපාධිධාරිනියක්ද
උපාදිදාරිනියක්ද => උපාධිධාරිනියක්ද
උපාදිදාරියෙකුට => උපාධිධාරියෙකුට
උපාදිදාරියෙකුට => උපාධිධාරියෙකුට
උපාදිදාරීන් => උපාධිධාරීන්
උපාදිදාරීන් => උපාධිධාරීන්
උපාදිය => උපාධිය
උපාදියක් => උපාධියක්
උල්ලංගනය => උල්ලංගණය
උල්ලංගණය => උල්ලංඝණය
උල්ලංඝනය => උල්ලංඝණය
උල්ලංගනය => උල්ලංඝනය
උස්ණ => උෂ්ණ
උෂ්න => උෂ්ණ
උස්ණත්වය => උෂ්ණත්වය
උෂ්නත්වය => උෂ්ණත්වය
උසස්පෙල => උසස්පෙළ
උලලේ => උළලේ
උලලේදී => උළලේදී
උලලේදීයි => උළලේදීයි
උලුකැටවැව => උළුකැටවැව
උලෙල => උළෙල
උලෙලට => උළෙලට
උලෙලේ => උළෙලේ
ඌන => ඌණ
ඍන => ඍණ
එකමුතුබාවය => එකමුතුභාවය
එක්කල => එක්කළ
එක්වුනා => එක්වුණා
එක්වුනේ => එක්වුණේ
එකාබද්දව => එකාබද්ධව
එන්ඒඒපුස්පකුමාර => එන්ඒඒපුෂ්පකුමාර
එරමිනියාය => එරමිණියාය
එලවලු => එලවළු
එලැබි => එලැඹි
එලඹ => එළඹ
එළබ => එළඹ
එලඹි => එළඹි
එළබි => එළඹි
එලඹිය => එළඹිය
එළබිය => එළඹිය
එලඹියේ => එළඹියේ
එළබියේ => එළඹියේ
එලඹීමට => එළඹීමට
එළබීමට => එළඹීමට
එලඹුණා => එළඹුණා
එළබුණා => එළඹුණා
එළඹුනා => එළඹුණා
එලඹුණු => එළඹුණු
එළබුණු => එළඹුණු
එළඹුනු => එළඹුණු
එලඹෙන => එළඹෙන
එළබෙන => එළඹෙන
එලඹෙනවාට => එළඹෙනවාට
එළබෙනවාට => එළඹෙනවාට
එලඹෙන්නේ => එළඹෙන්නේ
එළබෙන්නේ => එළඹෙන්නේ
එලඹෙනු => එළඹෙනු
එළබෙනු => එළඹෙනු
එලවන්න => එළවන්න
එලවලු => එළවලු
එලවලු => එළවළු
එලවලු => එළවළු
එලැඹි => එළැඹි
එළැබි => එළැඹි
එලැඹුණු => එළැඹුණු
එළැබුණු => එළැඹුණු
එළැඹුනු => එළැඹුණු
එලැඹෙන => එළැඹෙන
එළැබෙන => එළැඹෙන
එලි => එළි
එලිදක්වා => එළිදක්වා
එලිදැක්වීම => එළිදැක්වීම
එලිදැක්වුණා => එළිදැක්වුණා
එළිදැක්වුනා => එළිදැක්වුණා
එලිදැක්වූ => එළිදැක්වූ
එලිදැක්වූයේ => එළිදැක්වූයේ
එලිදැක්වේ => එළිදැක්වේ
එලිපෙහෙලි => එළිපෙහෙළි
එලිපෙහෙලි => එළිපෙහෙළි
එලිමහන් => එළිමහන්
එලියක් => එළියක්
එලියට => එළියට
එලියේදි => එළියේදි
එලුවන් => එළුවන්
එලුවන්කුලම => එළුවන්කුලම
එලෙස => එළෙස
ඒකකයබාර => ඒකකයභාර
ඒකරාසිවී => ඒකරාශිවී
ඒකරාසී => ඒකරාශී
ඒකාදිපති => ඒකාධිපති
ඒකාබද්ද => ඒකාබද්ධ
ඒකාබද්දව => ඒකාබද්ධව
ඒකාබන්ද => ඒකාබන්ධ
ඒකාරාසි => ඒකාරාශි
ඒසාන් => ඒෂාන්
ඔඩීසා => ඔඩීෂා
ඔසේන් => ඔෂේන්
ඔලුතුඩුවායි => ඔළුතුඩුවායි
ඔලුව => ඔළුව
ඔලුවෙත් => ඔළුවෙත්
ඔලුවේ => ඔළුවේ
ඕසධ => ඕෂධ
ඕෂද => ඕෂධ
ඕසන් => ඕෂන්
ඕසෙන් => ඕෂෙන්
ඖසධ => ඖෂධ
ඖෂද => ඖෂධ
කක්ස => කක්ෂ
කක්සගත => කක්ෂගත
කක්සයක => කක්ෂයක
කක්සයට => කක්ෂයට
කඩුලු => කඩුළු
කනගාටු => කණගාටු
කනගාටුදායක => කණගාටුදායක
කනගාටුව => කණගාටුව
කනගාටුවක් => කණගාටුවක්
කනගාටුවට => කණගාටුවට
කනගාටුවන => කණගාටුවන
කනගාටුවෙන් => කණගාටුවෙන්
කනඩායමක් => කණඩායමක්
කනඩායම් => කණඩායම්
කනසල්ලට => කණසල්ලට
කනස්සල්ල => කණස්සල්ල
කන්ඩයම => කණ්ඩයම
කන්ඩයම් => කණ්ඩයම්
කන්ඩයමේ => කණ්ඩයමේ
කන්ඩාම => කණ්ඩාම
කන්ඩාමට => කණ්ඩාමට
කන්ඩාම් => කණ්ඩාම්
කන්ඩාමේ => කණ්ඩාමේ
කන්ඩායම => කණ්ඩායම
කන්ඩායමක => කණ්ඩායමක
කන්ඩායමකට => කණ්ඩායමකට
කන්ඩායමකටයි => කණ්ඩායමකටයි
කන්ඩායමක් => කණ්ඩායමක්
කන්ඩායමක්ද => කණ්ඩායමක්ද
කන්ඩායමක්ම => කණ්ඩායමක්ම
කන්ඩායමකින් => කණ්ඩායමකින්
කන්ඩායමකුත් => කණ්ඩායමකුත්
කන්ඩායමට => කණ්ඩායමට
කන්ඩායමද => කණ්ඩායමද
කන්ඩායමයි => කණ්ඩායමයි
කන්ඩායම් => කණ්ඩායම්
කන්ඩායම්වල => කණ්ඩායම්වල
කන්ඩායම්වලට => කණ්ඩායම්වලට
කන්ඩායම්වලින් => කණ්ඩායම්වලින්
කන්ඩායමේ => කණ්ඩායමේ
කන්ඩායමේද => කණ්ඩායමේද
කනිෂ්ඨ => කණිෂ්ඨ
කණිස්ඨ => කණිෂ්ඨ
කනුව => කණුව
කත්මන්ඩු => කත්මණ්ඩු
කතාකල => කතාකළ
කතන => කථන
කතා => කථා
කතානානයක => කථානානයක
කතානායක => කථානායක
කතානායකගෙන් => කථානායකගෙන්
කතානායකට => කථානායකට
කතානායකතුමනි => කථානායකතුමනි
කතානායකවරයා => කථානායකවරයා
කතානායකවරයාගෙන් => කථානායකවරයාගෙන්
කතානායකවරයාට => කථානායකවරයාට
කතිකාචාර්ය => කථිකාචාර්ය
කතිකාවක් => කථිකාවක්
කතිකාවතක් => කථිකාවතක්
කදුලින් => කදුළින්
කදුලු => කදුළු
කන්ස්ට්රක්සන් => කන්ස්ට්රක්ෂන්
කබ => කඹ
කබුරුපිටිය => කඹුරුපිටිය
කරන => කරණ
කරන්දෙනිය => කරන්දෙණිය
කරන්දෙනියගේ => කරන්දෙණියගේ
කරන්දෙනියේ => කරන්දෙණියේ
කරබ => කරඹ
කරලියට => කරළියට
කර්මාන්තසාලා => කර්මාන්තශාලා
කර්මාන්තසාලාව => කර්මාන්තශාලාව
කර්මාන්තසාලාවක => කර්මාන්තශාලාවක
කර්මාන්තසාලාවේ => කර්මාන්තශාලාවේ
කර්මාන්තසාලාවේදී => කර්මාන්තශාලාවේදී
කරුන => කරුණ
කරුනක් => කරුණක්
කරුනට => කරුණට
කරුනා => කරුණා
කරුනාතිලක => කරුණාතිලක
කරුනානයක => කරුණානයක
කරුනානායක => කරුණානායක
කරුනානායකගෙන් => කරුණානායකගෙන්
කරුනානායකට => කරුණානායකට
කරුනානායකයි => කරුණානායකයි
කරුනායක => කරුණායක
කරුනාරත්න => කරුණාරත්න
කරුනාරත්නගෙන් => කරුණාරත්නගෙන්
කරුනාරත්නගේ => කරුණාරත්නගේ
කරුනාරත්නට => කරුණාරත්නට
කරුනාරත්නය => කරුණාරත්නය
කරුනාරත්නයි => කරුණාරත්නයි
කරුනාවක් => කරුණාවක්
කරුනාවෙන් => කරුණාවෙන්
කරුනු => කරුණු
කරුනුද => කරුණුද
කරුනුවලට => කරුණුවලට
කරුනූ => කරුණූ
කලමනාකාර => කලමණාකාර
කල්එලිය => කල්එළිය
කල්මුනකුඩි => කල්මුණකුඩි
කල්මුනෙන් => කල්මුණෙන්
කල්මුනේ => කල්මුණේ
කල්මුනේදි => කල්මුණේදි
කල්මුනේදී => කල්මුණේදී
කල => කළ
කලක් => කළක්
කලගහකන්දේ => කළගහකන්දේ
කලණ => කළණ
කළන => කළණ
කලත් => කළත්
කලද => කළද
කලමණාකරණ => කළමණාකරණ
කළමනාකරන => කළමණාකරණ
කළමනාකරන => කළමණාකරණ
කලමණාකරණය => කළමණාකරණය
කළමනාකරනය => කළමණාකරණය
කළමනාකරනය => කළමණාකරණය
කලමණාකරණයකින් => කළමණාකරණයකින්
කළමනාකරනයකින් => කළමණාකරණයකින්
කළමනාකරනයකින් => කළමණාකරණයකින්
කලමණාකරන => කළමණාකරන
කළමනාකරන => කළමණාකරන
කලමණාකරු => කළමණාකරු
කළමනාකරු => කළමණාකරු
කලමනාකරණ => කළමනාකරණ
කළමනාකරන => කළමනාකරණ
කලමනාකරණය => කළමනාකරණය
කළමනාකරනය => කළමනාකරණය
කලමනාකරු => කළමනාකරු
කලමනාකරුවෙකු => කළමනාකරුවෙකු
කලමනාකාරවරයා => කළමනාකාරවරයා
කලමනාකාරවරයාට => කළමනාකාරවරයාට
කලමනාකාරීත්වය => කළමනාකාරීත්වය
කලඹක් => කළඹක්
කළබක් => කළඹක්
කලයුතු => කළයුතු
කලවාන => කළවාන
කලහකාරී => කළහකාරී
කලහාකාරි => කළහාකාරි
කලහැකි => කළහැකි
කලහොත් => කළහොත්
කල්යාණි => කළ්යාණි
කළ්යානි => කළ්යාණි
කලා => කළා
කලාග => කළාග
කලාට => කළාට
කලාප => කළාප
කලාපය => කළාපය
කලාපයේ => කළාපයේ
කලාපීය => කළාපීය
කලැයි => කළැයි
කලු => කළු
කලුතර => කළුතර
කලුතරදී => කළුතරදී
කලුදෑවල => කළුදෑවල
කලුබෝවිටියාන => කළුබෝවිටියාන
කලුබෝවිල => කළුබෝවිල
කලෙමු => කළෙමු
කලේ => කළේ
කලේ => කළේ
කලේද => කළේද
කලේදැයි => කළේදැයි
කලේය => කළේය
කලේයැයි => කළේයැයි
කලේ් => කළේ්
ක්යුසු => ක්යුෂු
ක්රමානුකූලව => ක්රමාණුකූලව
ක්රිඩාංගනයේදියි => ක්රිඩාංගණයේදියි
ක්රිඩාංගනයේදීයි => ක්රිඩාංගණයේදීයි
ක්රියාකාරිනියක => ක්රියාකාරිණියක
ක්රීඩාංගනය => ක්රීඩාංගණය
ක්රීඩාංගනයට => ක්රීඩාංගණයට
ක්රීඩාංගනයේ => ක්රීඩාංගණයේ
ක්රීඩාංගනයේදීයි => ක්රීඩාංගණයේදීයි
ක්සණික => ක්ෂණික
ක්ෂනික => ක්ෂණික
ක්සණිකව => ක්ෂණිකව
ක්ෂනිකව => ක්ෂණිකව
ක්සේත්ර => ක්ෂේත්ර
ක්සේත්රය => ක්ෂේත්රය
ක්සේත්රයට => ක්ෂේත්රයට
ක්සේත්රයේ => ක්ෂේත්රයේ
ක්සේත්රවලදී => ක්ෂේත්රවලදී
ක්සේත්ර => ක්ෂේත්ර
ක්සේත්රය => ක්ෂේත්රය
ක්සේත්රයට => ක්ෂේත්රයට
ක්සේත්රයේ => ක්ෂේත්රයේ
ක්සේත්රවල => ක්ෂේත්රවල
කාන්ඩයේ => කාණ්ඩයේ
කාන්ඩයේයි => කාණ්ඩයේයි
කානු => කාණු
කාරන => කාරණ
කාරනය => කාරණය
කාරනයක් => කාරණයක්
කාරනයේදී => කාරණයේදී
කාරනා => කාරණා
කාරනාව => කාරණාව
කාරනාවකටද => කාරණාවකටද
කාරනාවක් => කාරණාවක්
කාරනාවලට => කාරණාවලට
කාර්යංස => කාර්යංශ
කාර්යංසය => කාර්යංශය
කාර්යංසයෙන් => කාර්යංශයෙන්
කාර්යක්සම => කාර්යක්ෂම
කාර්යක්සමතා => කාර්යක්ෂමතා
කාර්යක්සමව => කාර්යක්ෂමව
කාර්යබාරය => කාර්යභාරය
කාර්යාංස => කාර්යාංශ
කාර්යාංසය => කාර්යාංශය
කාර්යාංසයේ => කාර්යාංශයේ
කාලගුන => කාලගුණ
කාලගුනය => කාලගුණය
කාලගුනයක් => කාලගුණයක්
කාලගුනයට => කාලගුණයට
කාලගුනයත් => කාලගුණයත්
කාලගුනයෙන් => කාලගුණයෙන්
කාලගුනික => කාලගුණික
කාස්මිරයේදී => කාශ්මිරයේදී
කාස්මීර => කාශ්මීර
කාස්මීරයේ => කාශ්මීරයේ
කාස්මීර් => කාශ්මීර්
කාස්මීර => කාෂ්මීර
කාලගුණ => කාළගුණ
කාළගුන => කාළගුණ
කාලගුණික => කාළගුණික
කාළගුනික => කාළගුණික
කැකුනදොර => කැකුණදොර
කැනීම් => කැණීම්
කැනීම්වලදී => කැණීම්වලදී
කැපකල => කැපකළ
කැපවුනා => කැපවුණා
කැබලිවලට => කැබළිවලට
කැරලිකරුවන් => කැරළිකරුවන්
කැලනිය => කැලණිය
කැලබීමක් => කැලඹීමක්
කැලබු => කැලඹු
කැලණිය => කැළණිය
කැළනිය => කැළණිය
කැලණිවැලි => කැළණිවැලි
කැළනිවැලි => කැළණිවැලි
කැලඹිමේ => කැළඹිමේ
කැළබිමේ => කැළඹිමේ
කැලඹීමක් => කැළඹීමක්
කැළබීමක් => කැළඹීමක්
කැලඹු => කැළඹු
කැළබු => කැළඹු
කැලයට => කැළයට
කැලෑ => කැළෑ
කැලෑබද => කැළෑබද
කැලෑවක් => කැළෑවක්
කැලි => කැළි
කිනිස්සක් => කිණිස්සක්
කිතුනු => කිතුණු
කිතුනූ => කිතුණූ
කියලාපරිගනක => කියලාපරිගණක
කියවුනා => කියවුණා
කියවුනේ => කියවුණේ
කියුසු => කියුෂු
කිරුලපන => කිරුළපන
කිසූ => කිෂූ
කි්රඩාංගනයේ => කි්රඩාංගණයේ
කි්රයාකල => කි්රයාකළ
කි්රයාසීලි => කි්රයාශීලි
කි්රසාන්ත => කි්රෂාන්ත
කීරික්කුලම => කීරික්කුළම
කී්රඩංගනයේදීයි => කී්රඩංගණයේදීයි
කී්රඩාංගනය => කී්රඩාංගණය
කී්රඩාංගනයට => කී්රඩාංගණයට
කී්රඩාංගනයෙන් => කී්රඩාංගණයෙන්
කී්රඩාංගනයේ => කී්රඩාංගණයේ
කී්රඩාංගනයේදීයි => කී්රඩාංගණයේදීයි
කී්රීඩාංගනයේදී => කී්රීඩාංගණයේදී
කුනාටුව => කුණාටුව
කුනාටුවක් => කුණාටුවක්
කුනාටුවෙන් => කුණාටුවෙන්
කුනාටුවේ => කුණාටුවේ
කුමන => කුමණ
කුමන්ත්රන => කුමන්ත්රණ
කුමන්ත්රනකාරී => කුමන්ත්රණකාරී
කුමන්ත්රනය => කුමන්ත්රණය
කුමන්ත්රනයක => කුමන්ත්රණයක
කුමන්ත්රනයකට => කුමන්ත්රණයකට
කුමන්ත්රනයක් => කුමන්ත්රණයක්
කුමන්ත්රනයකින් => කුමන්ත්රණයකින්
කුබල් => කුඹල්
කුරානය => කුරාණය
කුරානයේ => කුරාණයේ
කුරුනෑගල => කුරුණෑගල
කුරුනෑගලට => කුරුණෑගලට
කුරුනෑගලදී => කුරුණෑගලදී
කුරේසි => කුරේෂි
කුලබේද => කුලභේද
කුලියට => කුළියට
කුලියාපිටිය => කුළියාපිටිය
කුලී => කුළී
කුලු => කුළු
කුලුණ => කුළුණ
කුළුන => කුළුණ
කුලුණු => කුළුණු
කුළුනු => කුළුණු
කුලුබඩු => කුළුබඩු
කෘත්යාදිකාරි => කෘත්යාධිකාරි
කෘත්යාදිකාරී => කෘත්යාධිකාරී
කෘසි => කෘෂි
කෘසිකර්ම => කෘෂිකර්ම
කෘසිකාර්මික => කෘෂිකාර්මික
කෙරලේ => කෙරළේ
කෙරිනි => කෙරිණි
කෙරුනත් => කෙරුණත්
කෙරුනද => කෙරුණද
කෙරුනා => කෙරුණා
කෙරුනු => කෙරුණු
කෙරුනූ => කෙරුණූ
කෙරුනේ => කෙරුණේ
කෙරුනේ => කෙරුණේ
කෙරුනේ් => කෙරුණේ්
කෙරෙනු => කෙරෙණු
කෙහෙලිය => කෙහෙළිය
කේන්ද්රස්තානය => කේන්ද්රස්ථානය
කේරල => කේරළ
කේරලයේ => කේරළයේ
කේසත්රයේ => කේෂත්රයේ
කේසර => කේෂර
කේස්ත්රයට => කේෂ්ත්රයට
කොකොලඹ => කොකොළඹ
කොකොළබ => කොකොළඹ
කොටකිබුල => කොටකිඹුල
කොට්ඨාස => කොට්ඨාශ
කොට්ඨාසය => කොට්ඨාශය
කොට්ඨාසයට => කොට්ඨාශයට
කොට්ඨාසයන්ට => කොට්ඨාශයන්ට
කොට්ඨාසයෙන් => කොට්ඨාශයෙන්
කොට්ඨාසයේ => කොට්ඨාශයේ
කොට්ඨාසවලට => කොට්ඨාශවලට
කොට්ඨාසය => කොට්ඨාෂය
කොට්ඨාසයට => කොට්ඨාෂයට
කොට්ඨාසයේ => කොට්ඨාෂයේ
කොටියාකුබුර => කොටියාකුඹුර
කොපමන => කොපමණ
කොපමනද => කොපමණද
කොමිසන් => කොමිෂන්
කොමිසමට => කොමිෂමට
කොමිසමෙන් => කොමිෂමෙන්
කොරේසිගේ => කොරේෂිගේ
කොලබ => කොලඹ
කොහොබ => කොහොඹ
කොල => කොළ
කොලණිය => කොළණිය
කොළනිය => කොළණිය
කොලඹ => කොළඹ
කොළබ => කොළඹ
කොලඹගේ => කොළඹගේ
කොළබගේ => කොළඹගේ
කොලඹට => කොළඹට
කොළබට => කොළඹට
කොලඹටත් => කොළඹටත්
කොළබටත් => කොළඹටත්
කොලඹදි => කොළඹදි
කොළබදි => කොළඹදි
කොලඹදී => කොළඹදී
කොළබදී => කොළඹදී
කොලඹින් => කොළඹින්
කොළබින් => කොළඹින්
කොලවලින් => කොළවලින්
කොලොන්නාව => කොළොන්නාව
කොලොන්පත්ද => කොළොන්පත්ද
කෝඩීස්වරම් => කෝඩීෂ්වරම්
කෝදීස්වරන් => කෝදීෂ්වරන්
කෝපරේසන් => කෝපරේෂන්
කෝලිලකුනු => කෝලිලකුණු
කෝවිල්කුලම් => කෝවිල්කුළම්
කෞසාල් => කෞෂාල්
කණජ => ඛණජ
ඛනජ => ඛණජ
කණිජ => ඛණිජ
ඛනිජ => ඛණිජ
කනිජ => ඛනිජ
කාන් => ඛාන්
කාන්ට => ඛාන්ට
කාන්ද => ඛාන්ද
කේදජනක => ඛේදජනක
කේදවාචකය => ඛේදවාචකය
කේදවාචකයකට => ඛේදවාචකයකට
කේදවාචකයක් => ඛේදවාචකයක්
කේදවාචකයට => ඛේදවාචකයට
ගනන => ගණන
ගනනක => ගණනක
ගනනක් => ගණනක්
ගනනකින් => ගණනකින්
ගනනද => ගණනද
ගනන් => ගණන්
ගනන්වල => ගණන්වල
ගනනාවක => ගණනාවක
ගනනාවකගෙන් => ගණනාවකගෙන්
ගනනාවකට => ගණනාවකට
ගනනාවකදී => ගණනාවකදී
ගනනාවක් => ගණනාවක්
ගනනාවක්ද => ගණනාවක්ද
ගනනාවකින් => ගණනාවකින්
ගනයේ => ගණයේ
ගනුදෙනු => ගණුදෙණු
ගනුදෙනු => ගණුදෙණු
ගනුදෙනුවක් => ගණුදෙණුවක්
ගනුදෙනුවක් => ගණුදෙණුවක්
ගනුදෙනුවට => ගණුදෙණුවට
ගනුදෙනුවට => ගණුදෙණුවට
ගනුදෙනු => ගණුදෙනු
ගනුදෙනුව => ගණුදෙනුව
ගනුදෙනුවට => ගණුදෙනුවට
ගනේමුල්ලේ => ගණේමුල්ලේ
ගතවුනු => ගතවුණු
ගතිගුන => ගතිගුණ
ගනුදෙනු => ගනුදෙණු
ගනුදෙනුවට => ගනුදෙණුවට
ගනේසන් => ගනේෂන්
ගම්පොල => ගම්පොළ
ගම්පොලදි => ගම්පොළදි
ගර්බණි => ගර්භණි
ගර්භනි => ගර්භණි
ගර්බණී => ගර්භණී
ගර්භනී => ගර්භණී
ගර්බයේ => ගර්භයේ
ගවේසකයෝ => ගවේශකයෝ
ගවේසකයේ => ගවේෂකයේ
ගවේසකයෝ => ගවේෂකයෝ
ගවේසණාත්මක => ගවේෂණාත්මක
ගවේෂනාත්මක => ගවේෂණාත්මක
ගලගොඩඅත්තේ => ගළගොඩඅත්තේ
ග්රන්ත => ග්රන්ථ
ග්රන්තය => ග්රන්ථය
ග්රන්තයක => ග්රන්ථයක
ග්රන්තයකින් => ග්රන්ථයකින්
ග්රහනය => ග්රහණය
ග්රහනයට => ග්රහණයට
ගාතාව => ගාථාව
ගාන්දි => ගාන්ධි
ගාන්දිගේ => ගාන්ධිගේ
ගාන්දිට => ගාන්ධිට
ගාමිනි => ගාමිණි
ගාමිනී => ගාමිණී
ගැටලු => ගැටළු
ගැටලුකාරී => ගැටළුකාරී
ගැටලුව => ගැටළුව
ගැටලුවකට => ගැටළුවකට
ගැටලුවක් => ගැටළුවක්
ගැටලුවක්ද => ගැටළුවක්ද
ගැටලුවක්ව => ගැටළුවක්ව
ගැටලුවකින් => ගැටළුවකින්
ගැටලුවලට => ගැටළුවලට
ගැටුනා => ගැටුණා
ගැනුනා => ගැණුනා
ගැනුනු => ගැණුනු
ගැනුනේ => ගැණුනේ
ගැනුුනා => ගැණුුනා
ගැනෙනවා => ගැණෙනවා
ගැනුනා => ගැනුණා
ගැනුනු => ගැනුණු
ගැනුනූ => ගැනුණූ
ගැනුනේ => ගැනුණේ
ගැනුනේ => ගැනුණේ
ගැනෙන => ගැනෙණ
ගැබිනි => ගැබිණි
ගැමුනු => ගැමුණු
ගැමුනුපුර => ගැමුණුපුර
ගැබුරත්වය => ගැඹුරත්වය
ගැබුරින් => ගැඹුරින්
ගැබුරු => ගැඹුරු
ගැබුරුදැයි => ගැඹුරුදැයි
ගැබුරුයි => ගැඹුරුයි
ගැසුනා => ගැසුණා
ගැහැනු => ගැහැණු
ගැලපුවහොත් => ගැළපුවහොත්
ගෑවුනු => ගෑවුණු
ගිනි => ගිණි
ගිනිකොන => ගිණිකොන
ගිනුම => ගිණුම
ගිනුමට => ගිණුමට
ගිනුම් => ගිණුම්
ගිනුම්වල => ගිණුම්වල
ගිනුම්වලට => ගිණුම්වලට
ගිනුමේ => ගිණුමේ
ගිනුමේද => ගිණුමේද
ගිනිකෙල => ගිනිකෙළ
ගිනිකෙලි => ගිනිකෙළි
ගිලන්රත => ගිලන්රථ
ගිලිහුනු => ගිලිහුණු
ගුඞ්සෙඞ් => ගුඞ්ශෙඞ්
ගුඞ්සෙඞ් => ගුඞ්ෂෙඞ්
ගුන => ගුණ
ගුනතිලක => ගුණතිලක
ගුනතිලකටත් => ගුණතිලකටත්
ගුනරත්න => ගුණරත්න
ගුනරත්නගෙන් => ගුණරත්නගෙන්
ගුනරත්නගේ => ගුණරත්නගේ
ගුනරත්නටයි => ගුණරත්නටයි
ගුනවංශ => ගුණවංශ
ගුණවංස => ගුණවංශ
ගුනවර්ධන => ගුණවර්ධන
ගුණවර්දන => ගුණවර්ධන
ගුනවර්ධනට => ගුණවර්ධනට
ගුණවර්දනට => ගුණවර්ධනට
ගුනවර්ධනටද => ගුණවර්ධනටද
ගුණවර්දනටද => ගුණවර්ධනටද
ගුනසේකර => ගුණසේකර
ගුනසේකරගෙන් => ගුණසේකරගෙන්
ගුනාත්මකභාවය => ගුණාත්මකභාවය
ගුණාත්මකබාවය => ගුණාත්මකභාවය
ගුවන්තොටුපලට => ගුවන්තොටුපළට
ගේ්රසාන් => ගේ්රෂාන්
ගොනු => ගොණු
ගොනුකර => ගොණුකර
ගොනුකළ => ගොණුකළ
ගොණුකල => ගොණුකළ
ගොනුකල => ගොනුකළ
ගෝඨාබය => ගෝඨාභය
ගෝඨාබයගම => ගෝඨාභයගම
ගෝඨාබයගේ => ගෝඨාභයගේ
ගෝඨාබයට => ගෝඨාභයට
ගෝඨාබයයි => ගෝඨාභයයි
ගෞරවනිය => ගෞරවණිය
ගණ => ඝණ
ඝන => ඝණ
ගන => ඝන
ගනක => ඝනක
ගර්භයේ => ඝර්භයේ
ඝර්බයේ => ඝර්භයේ
ගාතකයන් => ඝාතකයන්
ගාතකයා => ඝාතකයා
ගාතන => ඝාතන
ගාතනය => ඝාතනය
ගාතනයක් => ඝාතනයක්
ගාතනයට => ඝාතනයට
ගාතනයන් => ඝාතනයන්
ගාතනයන්ට => ඝාතනයන්ට
ගාතනයේ => ඝාතනයේ
ගෝෂා => ඝෝෂා
ඝෝසා => ඝෝෂා
ගෝෂාකාරී => ඝෝෂාකාරී
ඝෝසාකාරී => ඝෝෂාකාරී
චක්රලේක => චක්රලේඛ
චක්රලේකය => චක්රලේඛය
චක්රලේකයක් => චක්රලේඛයක්
චක්රලේකයට => චක්රලේඛයට
චක්රලේකයේ => චක්රලේඛයේ
චන්ඩ => චණ්ඩ
චිරප්රසිද්ද => චිරප්රසිද්ධ
චුන්ඩක්කුලි => චුණ්ඩක්කුලි
චුන්ඩිකුලි => චුණ්ඩිකුලි
චුන්ඩුකුළි => චුණ්ඩුකුළි
චුණ්ඩුකුලි => චුණ්ඩුකුළි
චුම්බක => චුම්භක
චන්ද => ඡන්ද
චන්දය => ඡන්දය
චන්දයෙන් => ඡන්දයෙන්
චන්දයේදී => ඡන්දයේදී
චන්දෙ => ඡන්දෙ
චන්ම => ඡන්ම
චාතිකයින් => ඡාතිකයින්
චායාපිටපත් => ඡායාපිටපත්
චායාරුප => ඡායාරුප
චායාරූප => ඡායාරූප
චායාරූපගත් => ඡායාරූපගත්
චායාරූපය => ඡායාරූපය
චායාරූපයක් => ඡායාරූපයක්
චායාරූපයක්ද => ඡායාරූපයක්ද
චායාරූපයේ => ඡායාරූපයේ
චායාරූපවල => ඡායාරූපවල
චුන්ද => ඡුන්ද
චුායාරූප => ඡුායාරූප
චේදයක => ඡේදයක
ජනමතවිචාරන => ජනමතවිචාරණ
ජනමතවිචාරනය => ජනමතවිචාරණය
ජනමතවිචාරනයක් => ජනමතවිචාරණයක්
ජනමාද්ය => ජනමාධ්ය
ජනමාද්යයන්ට => ජනමාධ්යයන්ට
ජනමාද්යවේදියෙකු => ජනමාධ්යවේදියෙකු
ජනලේකන => ජනලේඛන
ජනාකීර්න => ජනාකීර්ණ
ජනාදිපති => ජනාධිපති
ජනාදිපතිට => ජනාධිපතිට
ජනාදිපතිතුමා => ජනාධිපතිතුමා
ජනාදිපතිතුමාගෙන් => ජනාධිපතිතුමාගෙන්
ජනාදිපතිතුමාගේ => ජනාධිපතිතුමාගේ
ජනාදිපතිතුමාට => ජනාධිපතිතුමාට
ජනාදිපතිතුමාත් => ජනාධිපතිතුමාත්
ජනාදිපතිතුමාද => ජනාධිපතිතුමාද
ජනාදිපතිදුරය => ජනාධිපතිධුරය
ජනාදිපතිදුරය => ජනාධිපතිධුරය
ජනාදිපතිදූර => ජනාධිපතිධූර
ජනාදිපතිදූර => ජනාධිපතිධූර
ජනාදිපතිනි => ජනාධිපතිනි
ජනාදිපතිනියට => ජනාධිපතිනියට
ජනාදිපතිවයා => ජනාධිපතිවයා
ජනාදිපතිවරණ => ජනාධිපතිවරණ
ජනාධිපතිවරන => ජනාධිපතිවරණ
ජනාදිපතිවරණය => ජනාධිපතිවරණය
ජනාධිපතිවරනය => ජනාධිපතිවරණය
ජනාදිපතිවරණයකට => ජනාධිපතිවරණයකට
ජනාධිපතිවරනයකට => ජනාධිපතිවරණයකට
ජනාදිපතිවරණයක් => ජනාධිපතිවරණයක්
ජනාධිපතිවරනයක් => ජනාධිපතිවරණයක්
ජනාදිපතිවරණයට => ජනාධිපතිවරණයට
ජනාධිපතිවරනයට => ජනාධිපතිවරණයට
ජනාදිපතිවරණයේ => ජනාධිපතිවරණයේ
ජනාධිපතිවරනයේ => ජනාධිපතිවරණයේ
ජනාදිපතිවරණයේදී => ජනාධිපතිවරණයේදී
ජනාධිපතිවරනයේදී => ජනාධිපතිවරණයේදී
ජනාදිපතිවරයා => ජනාධිපතිවරයා
ජනාදිපතිවරයාගෙන් => ජනාධිපතිවරයාගෙන්
ජනාදිපතිවරයාගේ => ජනාධිපතිවරයාගේ
ජනාදිපතිවරයාට => ජනාධිපතිවරයාට
ජනාදිපතිවරයාටත් => ජනාධිපතිවරයාටත්
ජනාදිපතිවරයායි => ජනාධිපතිවරයායි
ජනාදිපතිවරයෙක් => ජනාධිපතිවරයෙක්
ජනාදිපතිවරයෙකු => ජනාධිපතිවරයෙකු
ජනාදිපතිවරුන් => ජනාධිපතිවරුන්
ජනාදිපවරණයක් => ජනාධිපවරණයක්
ජනාධිපවරනයක් => ජනාධිපවරණයක්
ජයග්රහන => ජයග්රහණ
ජයග්රහනය => ජයග්රහණය
ජයග්රහනයක් => ජයග්රහණයක්
ජයග්රහනයට => ජයග්රහණයට
ජයග්රහනයත් => ජයග්රහණයත්
ජයග්රහනයද => ජයග්රහණයද
ජයග්රහනයෙන් => ජයග්රහණයෙන්
ජයග්රහනයේ => ජයග්රහණයේ
ජයග්රාහනය => ජයග්රාහණය
ජයග්රාහනයක් => ජයග්රාහණයක්
ජයවර්දණ => ජයවර්ධණ
ජයවර්ධන => ජයවර්ධණ
ජයවර්දන => ජයවර්ධන
ජයවර්දනගෙන් => ජයවර්ධනගෙන්
ජයවර්දනගේ => ජයවර්ධනගේ
ජයවර්දනද => ජයවර්ධනද
ජයවර්දනපුර => ජයවර්ධනපුර
ජයවර්දනයි => ජයවර්ධනයි
ජයස්රී => ජයශ්රී
ජයසී්ර => ජයශී්ර
ජලාස => ජලාශ
ජලාසයේ => ජලාශයේ
ජලාසවල => ජලාශවල
ජලාසවලට => ජලාශවලට
ජ්යෙස්ඨ => ජ්යෙෂ්ඨ
ජ්යෙස්ඨත්ත්වය => ජ්යෙෂ්ඨත්ත්වය
ජ්යෙස්ඨයින් => ජ්යෙෂ්ඨයින්
ජ්යෙස්ඨ්ය => ජ්යෙෂ්ඨ්ය
ජ්යේස්ඨ => ජ්යේෂ්ඨ
ජාඇල => ජාඇළ
ජාවාරම්කල => ජාවාරම්කළ
ජිවිතක්සයට => ජිවිතක්ෂයට
ජීවිතක්සයට => ජීවිතක්ෂයට
ජීසුගර් => ජීෂුගර්
ජේස් => ජේෂ්
ජේස්ඨ => ජේෂ්ඨ
ජේ්යස්ඨ => ජේ්යෂ්ඨ
ජෝසප් => ජෝශප්
ජෝසප් => ජෝෂප්
ඤානරතනාභිධාන => ඤාණරතනාභිධාන
ඤාණරතනාබිධාන => ඤාණරතනාභිධාන
ඤාණරතනාභිදාන => ඤාණරතනාභිධාන
ඥනසාර => ඥණසාර
ඥානදීප => ඥාණදීප
ඥානරතන => ඥාණරතන
ඥානසාර => ඥාණසාර
ට්රෙසරිස් => ට්රෙෂරිස්
ට්රෙසරීස් => ට්රෙෂරීස්
ටේරසරිස් => ටේරෂරිස්
ටේරසරීස් => ටේරෂරීස්
ඩිජිටල්කරනය => ඩිජිටල්කරණය
ඩොයිස් => ඩොයිෂ්
නය => ණය
නයගැති => ණයගැති
නයයි => ණයයි
තක්සිල => තක්ෂිල
තජිකිස්තානය => තජිකිස්ථානය
තජිකිස්තානයට => තජිකිස්ථානයට
තජිකිස්තානයේ => තජිකිස්ථානයේ
තන => තණ
තනතිලි => තණතිලි
තනතීරු => තණතීරු
තනතීරුව => තණතීරුව
තනතීරුවද => තණතීරුවද
තනතීරුවල => තණතීරුවල
තනතීරුවලට => තණතීරුවලට
තනමල්විල => තණමල්විල
තබ => තඹ
තබදිය => තඹදිය
තබලගම => තඹලගම
තබුත්තේගම => තඹුත්තේගම
තරනය => තරණය
තරනයට => තරණයට
තර්ජනයක්ද => තර්ජණයක්ද
තර්ජනයක්ව => තර්ජණයක්ව
තර්ජනාත්මක => තර්ජණාත්මක
තරුන => තරුණ
තරුනයකු => තරුණයකු
තරුනයන් => තරුණයන්
තරුනයා => තරුණයා
තරුනයාගේ => තරුණයාගේ
තරුනයාව => තරුණයාව
තරුනයින් => තරුණයින්
තරුනයින්ගේ => තරුණයින්ගේ
තරුනයෙක් => තරුණයෙක්
තරුනයෙකු => තරුණයෙකු
තරුනයෙකුගේ => තරුණයෙකුගේ
තරුනිය => තරුණිය
තරුනියක් => තරුණියක්
තරුනියගේ => තරුණියගේ
තරුනියන් => තරුණියන්
තරුනියව => තරුණියව
තහවුරුබාවය => තහවුරුභාවය
තලා => තළා
ත්යාගලාබී => ත්යාගලාභී
ත්රිකුනාම => ත්රිකුණාම
ත්රිකුනාමය => ත්රිකුණාමය
ත්රිකුනාමලය => ත්රිකුණාමලය
ත්රිකුනාමලයට => ත්රිකුණාමලයට
ත්රිකුනාමලයෙනුත් => ත්රිකුණාමලයෙනුත්
ත්රිකුනාමලයේ => ත්රිකුණාමලයේ
ත්රිව්ද => ත්රිව්ධ
ත්රිවිද => ත්රිවිධ
ත්රීකුනාමලය => ත්රීකුණාමලය
තාක්සණ => තාක්ෂණ
තාක්ෂන => තාක්ෂණ
තාක්සණය => තාක්ෂණය
තාක්ෂනය => තාක්ෂණය
තාක්සණයෙන් => තාක්ෂණයෙන්
තාක්ෂනයෙන් => තාක්ෂණයෙන්
තාක්සණයේ => තාක්ෂණයේ
තාක්ෂනයේ => තාක්ෂණයේ
තාක්සණික => තාක්ෂණික
තාක්ෂනික => තාක්ෂණික
තැබුනා => තැබුණා
තැබුනු => තැබුණු
තිබිනි => තිබිණි
තිබුන => තිබුණ
තිබුනත් => තිබුණත්
තිබුනද => තිබුණද
තිබුනා => තිබුණා
තිබුනි => තිබුණි
තිබුනු => තිබුණු
තිබුනේ => තිබුණේ
තිබුනේ => තිබුණේ
තිබුනේද => තිබුණේද
තිබූනා => තිබූණා
තියුනු => තියුණු
තියෙනවාජනාදිපතිවරයාට => තියෙනවාජනාධිපතිවරයාට
තිරනය => තිරණය
තිරනයක් => තිරණයක්
තිලිණ => තිළිණ
තිළින => තිළිණ
තිලිණි => තිළිණි
තිළිනි => තිළිණි
ති්රකුනාමලය => ති්රකුණාමලය
ති්රවිද => ති්රවිධ
තීරන => තීරණ
තීරනය => තීරණය
තීරනයකට => තීරණයකට
තීරනයක් => තීරණයක්
තීරනයකික් => තීරණයකික්
තීරනයකින් => තීරණයකින්
තීරනයට => තීරණයට
තීරනයත් => තීරණයත්
තීරනයන් => තීරණයන්
තීරනයෙන් => තීරණයෙන්
තීරනයේම => තීරණයේම
තීරනාත්මක => තීරණාත්මක
තී්රකුනාමල => තී්රකුණාමල
තී්රකුනාමලය => තී්රකුණාමලය
තී්රකුනාමලයේ => තී්රකුණාමලයේ
තුසාර => තුෂාර
තුල => තුළ
තුලට => තුළට
තුලටම => තුළටම
තුලත් => තුළත්
තුලද => තුළද
තුලදි => තුළදි
තුලදී => තුළදී
තුලදීම => තුළදීම
තුලයි => තුළයි
තුලින් => තුළින්
තුලින්ද => තුළින්ද
තෙල්දෙනිය => තෙල්දෙණිය
තෙල්මිල => තෙල්මිළ
තොරනක් => තොරණක්
තොටුපල => තොටුපළ
තොටුපලට => තොටුපළට
තොටුපලවල් => තොටුපළවල්
තොටුපලින් => තොටුපළින්
තොටුපලෙන් => තොටුපළෙන්
තොටුපලේදී => තොටුපළේදී
තොටුපලේ => තොටුපළේ
තොටුපලේදී => තොටුපළේදී
තොන්ඩමන් => තොණ්ඩමන්
තොරන => තොරණ
දක්ස => දක්ෂ
දක්සකම් => දක්ෂකම්
දක්සතා => දක්ෂතා
දක්සතාව => දක්ෂතාව
දක්සතාවය => දක්ෂතාවය
දක්සතාවයෙන් => දක්ෂතාවයෙන්
දක්සිණ => දක්ෂිණ
දක්ෂින => දක්ෂිණ
දකුන => දකුණ
දකුනට => දකුණට
දකුනු => දකුණු
දකුනේ => දකුණේ
දනහිසේ => දණහිසේ
දන්ඩ => දණ්ඩ
දන්ඩනය => දණ්ඩණය
දන්ඩනය => දණ්ඩණය
දන්ඩනය => දණ්ඩනය
දන්ඩනයන් => දණ්ඩනයන්
දනින් => දණින්
දනුස්ටන් => දනුෂ්ටන්
දමිල => දමිළ
දබගොල්ල => දඹගොල්ල
දබදෙණිය => දඹදෙණිය
දඹදෙනිය => දඹදෙණිය
දබර => දඹර
දබල්ල => දඹල්ල
දබුල්ල => දඹුල්ල
දබුල්ලල => දඹුල්ලල
දබුල්ලෙන් => දඹුල්ලෙන්
දබුල්ලේ => දඹුල්ලේ
දබුල්ලේදී => දඹුල්ලේදී
දබුල්ලේදීයි => දඹුල්ලේදීයි
දබුලු => දඹුලු
දබුළු => දඹුළු
දඹුලු => දඹුළු
දරන => දරණ
දරනු => දරණු
දර්සක => දර්ශක
දර්සකය => දර්ශකය
දර්සණ => දර්ශණ
දර්ශන => දර්ශණ
දර්සණය => දර්ශණය
දර්ශනය => දර්ශණය
දර්සන => දර්ශන
දර්සනද => දර්ශනද
දර්සනපති => දර්ශනපති
දර්සනය => දර්ශනය
දර්සනයක් => දර්ශනයක්
දර්සනයේ => දර්ශනයේ
දර්සනවල => දර්ශනවල
දර්සනීය => දර්ශනීය
දර්සායි => දර්ශායි
දරුනු => දරුණු
දරුනුම => දරුණුම
දරුපල => දරුඵල
දසක => දශක
දසකයක => දශකයක
දසකයේ => දශකයේ
දසම => දශම
දස්ටනයනේ => දෂ්ටනයනේ
දස්ඨ => දෂ්ඨ
දල => දළ
දලදා => දළදා
දලඳා => දළඳා
දලඹුවන් => දළඹුවන්
දළබුවන් => දළඹුවන්
දලුපිටිය => දළුපිටිය
ද්විපාර්ස්වික => ද්විපාර්ශ්වික
ද්වේසයක් => ද්වේෂයක්
දැක්වුනේ => දැක්වුණේ
දැනුම් => දැණුම්
දැමුනා => දැමුණා
දැමුනු => දැමුණු
දැමුනේ => දැමුණේ
දිනූසා => දිනූෂා
දිනේස් => දිනේෂ්
දිනේ්ස් => දිනේ්ෂ්
දිබුල => දිඹුල
දිබුල්කුබුරේ => දිඹුල්කුඹුරේ
දිබුල්කුබුරේ => දිඹුල්කුඹුරේ
දිබුලාගල => දිඹුලාගල
දියනිය => දියණිය
දියනියක් => දියණියක්
දියනියගෙන් => දියණියගෙන්
දියනියගේ => දියණියගේ
දියනියි => දියණියි
දියනීය => දියණීය
දියුනු => දියුණු
දියුනුව => දියුණුව
දියුනුවත් => දියුණුවත්
දිර්ග => දිර්ඝ
දිල්රුක්ස => දිල්රුක්ෂ
දිසාව => දිශාව
දිලින්දන් => දිළින්දන්
දිලිඳු => දිළිඳු
දීර්ග => දීර්ඝ
දුක්ගන්නාරාල => දුක්ගන්නාරාළ
දුටුගැමුනු => දුටුගැමුණු
දුනුසිංහ => දුණුසිංහ
දුම්කොල => දුම්කොළ
දුම්රියපල => දුම්රියපළ
දුරකතන => දුරකථන
දුරකතනය => දුරකථනය
දුරකතනයක් => දුරකථනයක්
දුරකතනයෙන් => දුරකථනයෙන්
දුරකතනවල => දුරකථනවල
දුර්ගන්දයක් => දුර්ගන්ධයක්
දුර්ලබ => දුර්ලභ
දුසණ => දුෂණ
දුෂන => දුෂණ
දුසණය => දුෂණය
දුෂනය => දුෂණය
දුස්කර => දුෂ්කර
දුස්කරතා => දුෂ්කරතා
දුස්කරතාද => දුෂ්කරතාද
දුස්කරතාවට => දුෂ්කරතාවට
දුස්කරතාවයන්ට => දුෂ්කරතාවයන්ට
දුස්කරතාවලට => දුෂ්කරතාවලට
දූසණ => දූෂණ
දූෂන => දූෂණ
දූසණය => දූෂණය
දූෂනය => දූෂණය
දූසණයට => දූෂණයට
දූෂනයට => දූෂණයට
දූසණයෙන් => දූෂණයෙන්
දූෂනයෙන් => දූෂණයෙන්
දූසිතව => දූෂිතව
දෙපල => දෙපළ
දෙපලක් => දෙපළක්
දෙපාර්සයවයටම => දෙපාර්ශයවයටම
දෙපාර්සවය => දෙපාර්ශවය
දෙපාර්සවයට => දෙපාර්ශවයට
දෙපාර්සවයටම => දෙපාර්ශවයටම
දෙපාර්සවයම => දෙපාර්ශවයම
දෙපාර්සවයෙන්ම => දෙපාර්ශවයෙන්ම
දෙපාර්සවයේ => දෙපාර්ශවයේ
දෙපාර්ස්වය => දෙපාර්ශ්වය
දෙපාර්ස්වයටම => දෙපාර්ශ්වයටම
දෙපාර්ස්වයම => දෙපාර්ශ්වයම
දෙපාර්ස්වයේම => දෙපාර්ශ්වයේම
දෙපිලටම => දෙපිළටම
දෙපිලම => දෙපිළම
දෙමල => දෙමළ
දෙලක්ස => දෙලක්ෂ
දෙලක්සය => දෙලක්ෂය
දෙලක්සයකට => දෙලක්ෂයකට
දෙලක්සයක් => දෙලක්ෂයක්
දෙවස්තානය => දෙවස්ථානය
දෙව්මිනි => දෙව්මිණි
දෙහිදෙනිය => දෙහිදෙණිය
දේස => දේශ
දේපල => දේපළ
දේපලවලද => දේපළවලද
දේපොලවලට => දේපොළවලට
දේමුනී => දේමුණී
දේවස්තාන => දේවස්ථාන
දේවස්තානත් => දේවස්ථානත්
දේවස්තානය => දේවස්ථානය
දේවස්තානයක => දේවස්ථානයක
දේවස්තානයකට => දේවස්ථානයකට
දේවස්තානයකදී => දේවස්ථානයකදී
දේවස්තානයක් => දේවස්ථානයක්
දේවස්තානයට => දේවස්ථානයට
දේවස්තානයටද => දේවස්ථානයටද
දේවස්තානයද => දේවස්ථානයද
දේවස්තානයන්හි => දේවස්ථානයන්හි
දේවස්තානයේ => දේවස්ථානයේ
දේවස්තානයේත් => දේවස්ථානයේත්
දේවස්තානයේද => දේවස්ථානයේද
දේවස්තානයේදිය => දේවස්ථානයේදිය
දේවස්තානයේදී => දේවස්ථානයේදී
දේවස්තානයේදීද => දේවස්ථානයේදීද
දේවස්තානවල => දේවස්ථානවල
දේවස්තානවලට => දේවස්ථානවලට
දේවාස්තානයේ => දේවාස්ථානයේ
දේවාස්තානයේදි => දේවාස්ථානයේදි
දේස => දේශ
දේසක => දේශක
දේසණ => දේශණ
දේශන => දේශණ
දේසණයන්ට => දේශණයන්ට
දේශනයන්ට => දේශණයන්ට
දේසණා => දේශණා
දේශනා => දේශණා
දේසන => දේශන
දේසනද => දේශනද
දේසනය => දේශනය
දේසනයක් => දේශනයක්
දේසනවලට => දේශනවලට
දේසනා => දේශනා
දේසනාවක් => දේශනාවක්
දේසනාවෙන් => දේශනාවෙන්
දේසපලාඥයෙකු => දේශපලාඥයෙකු
දේසප්රිය => දේශප්රිය
දේසපාලකයන්ගෙන් => දේශපාලකයන්ගෙන්
දේසපාලකයින් => දේශපාලකයින්
දේසපාලකයෙක් => දේශපාලකයෙක්
දේසපාලඥයා => දේශපාලඥයා
දේසපාලඥයින් => දේශපාලඥයින්
දේසපාලඥයින්ගෙන් => දේශපාලඥයින්ගෙන්
දේසපාලඥයින්ගේ => දේශපාලඥයින්ගේ
දේසපාලඥයෙකු => දේශපාලඥයෙකු
දේසපාලන => දේශපාලන
දේසපාලනඥයින් => දේශපාලනඥයින්
දේසපාලනඥයින්ට => දේශපාලනඥයින්ට
දේසපාලනඥයින්ම => දේශපාලනඥයින්ම
දේසපාලනඥයෙක් => දේශපාලනඥයෙක්
දේසපාලනඥයෙකු => දේශපාලනඥයෙකු
දේසපාලනඳයෙකු => දේශපාලනඳයෙකු
දේසපාලනය => දේශපාලනය
දේසපාලනයක් => දේශපාලනයක්
දේසපාලනයට => දේශපාලනයට
දේසපාලනයටද => දේශපාලනයටද
දේසපාලනයෙන් => දේශපාලනයෙන්
දේසපාලනයේ => දේශපාලනයේ
දේසපාලනික => දේශපාලනික
දේසපේ්රමී => දේශපේ්රමී
දේසය => දේශය
දේසයක => දේශයක
දේසයක් => දේශයක්
දේසයට => දේශයට
දේසයයි => දේශයයි
දේසසීමා => දේශසීමා
දේසසීමාව => දේශසීමාව
දේසසීමාවට => දේශසීමාවට
දේසසීමාවේ => දේශසීමාවේ
දේසහිතෛෂී => දේශහිතෛෂී
දේශහිතෛසී => දේශහිතෛෂී
දේසාපලන => දේශාපලන
දේසාලන => දේශාලන
දේසීය => දේශීය
දොඩම්වල => දොඩම්වළ
දොබකරයක => දොඹකරයක
දොබගහවෙල => දොඹගහවෙල
දෝනි => දෝණි
දෝනිට => දෝණිට
දෝස => දෝෂ
දෝසය => දෝෂය
දෝසයකට => දෝෂයකට
දෝසයක් => දෝෂයක්
දෝසයට => දෝෂයට
දෝසාභියෝගයකටත් => දෝෂාභියෝගයකටත්
දෝෂාබියෝගයකටත් => දෝෂාභියෝගයකටත්
දෝසාභියෝගයක් => දෝෂාභියෝගයක්
දෝෂාබියෝගයක් => දෝෂාභියෝගයක්
දෝසාරෝපණය => දෝෂාරෝපණය
දෝෂාරෝපනය => දෝෂාරෝපණය
දජ => ධජ
දජද => ධජද
දජය => ධජය
දජයක් => ධජයක්
දජයට => ධජයට
දජයද => ධජයද
දන => ධන
දනංජය => ධනංජය
දනන්ජය => ධනන්ජය
දනවත් => ධනවත්
දනවතෙකු => ධනවතෙකු
දනාත්මක => ධනාත්මක
දනුෂ => ධනුෂ
ධනුස => ධනුෂ
දනුෂ්ක => ධනුෂ්ක
ධනුස්ක => ධනුෂ්ක
දම්ම => ධම්ම
දම්මදස්සි => ධම්මදස්සි
දම්මදස්සී => ධම්මදස්සී
දම්මරතන => ධම්මරතන
දම්මරත්න => ධම්මරත්න
දම්මසිද්දි => ධම්මසිද්ධි
දම්මසිද්දි => ධම්මසිද්ධි
දම්ම්ජෝති => ධම්ම්ජෝති
දම්මානන්ද => ධම්මානන්ද
දම්මාරාම => ධම්මාරාම
දම්මාලංකාර => ධම්මාලංකාර
දම්මික => ධම්මික
දම්සිරි => ධම්සිරි
දර්ම => ධර්ම
දර්මපාල => ධර්මපාල
දර්මපුරම් => ධර්මපුරම්
දර්මය => ධර්මය
දර්මයට => ධර්මයට
දර්මවිජයාලෝක => ධර්මවිජයාලෝක
දර්මාපාල => ධර්මාපාල
දවල => ධවල
දවාන් => ධවාන්
දාතු => ධාතු
දාතුන් => ධාතුන්
දාතුසේනපුර => ධාතුසේනපුර
දාතූන් => ධාතූන්
දාරිතාව => ධාරිතාව
දාරිතාවක් => ධාරිතාවක්
දාරිතාවෙන් => ධාරිතාවෙන්
දාවන => ධාවන
දාවනය => ධාවනය
දාවනයට => ධාවනයට
දාවනයද => ධාවනයද
දාවනයවිමට => ධාවනයවිමට
දාවනයවීමට => ධාවනයවීමට
දාවනයවූ => ධාවනයවූ
දාවනයෙන් => ධාවනයෙන්
දාවනයේ => ධාවනයේ
දිවර => ධිවර
දිවරයින්ට => ධිවරයින්ට
දීරානන්ද => ධීරානන්ද
දීවර => ධීවර
දීවරයන්ගේ => ධීවරයන්ගේ
දීවරයින් => ධීවරයින්
දීවරයින්ට => ධීවරයින්ට
දුයෙන් => ධුයෙන්
දුර => ධුර
දුරය => ධුරය
දුරයක් => ධුරයක්
දුරයට => ධුරයට
දුරයන් => ධුරයන්
දුරයන්ගෙන් => ධුරයන්ගෙන්
දුරයන්හි => ධුරයන්හි
දුරයෙන් => ධුරයෙන්
දුරයේ => ධුරයේ
දුරවල => ධුරවල
දුරවලම => ධුරවලම
දුරවලින් => ධුරවලින්
දූර => ධූර
දූරය => ධූරය
දූරයක => ධූරයක
දූරයක් => ධූරයක්
දූරයට => ධූරයට
දූරයන්ගෙන් => ධූරයන්ගෙන්
දූරයෙන් => ධූරයෙන්
දූරයේ => ධූරයේ
දූරවල => ධූරවල
දූරවලින් => ධූරවලින්
දූරාවලිය => ධූරාවලිය
දෛර්ය => ධෛර්ය
නගරාදිපති => නගරාධිපති
නගරාදිපතිවරයා => නගරාධිපතිවරයා
නගරාදිපතිවරයාට => නගරාධිපතිවරයාට
නගරාස්රිත => නගරාශ්රිත
නදීසා => නදීෂා
නරබන => නරඹන
නරබන්න => නරඹන්න
නරබන්නන් => නරඹන්නන්
නරබනු => නරඹනු
නරබා => නරඹා
නවකවදය => නවකවධය
නවකවදයෙන් => නවකවධයෙන්
නවීකරනය => නවීකරණය
නවීකරනයට => නවීකරණයට
නවීකරනයන් => නවීකරණයන්
නසීඩ් => නෂීඩ්
නල => නළ
නලලේ => නළලේ
නලු => නළු
නලුවා => නළුවා
නලුවාට => නළුවාට
න්යස්ටික => න්යෂ්ටික
න්යස්ඨික => න්යෂ්ඨික
නාත්තන්ඩිය => නාත්තණ්ඩිය
නාත => නාථ
නාසක => නාශක
නාලිකා => නාළිකා
නැගුනු => නැගුණු
නැන්දනියගේ => නැන්දණියගේ
නැබුරු => නැඹුරු
නැබුරුවක් => නැඹුරුවක්
නැරබිය => නැරඹිය
නැරබීම => නැරඹීම
නැරබීමට => නැරඹීමට
නැරබීමටද => නැරඹීමටද
නැරබු => නැරඹු
නැවතුම්පොල => නැවතුම්පොළ
නැවතුම්පොලෙන් => නැවතුම්පොළෙන්
නෑඒකාබද්ද => නෑඒකාබද්ධ
නික්මුනේ => නික්මුණේ
නිට්ටබුව => නිට්ටඹුව
නිතිවිරෝදි => නිතිවිරෝධි
නිතිවිරෝදී => නිතිවිරෝධී
නිදන් => නිධන්
නිපුනතා => නිපුණතා
නිර්න => නිර්ණ
නිර්දේස => නිර්දේශ
නිර්දේසය => නිර්දේශය
නිර්දේසයකට => නිර්දේශයකට
නිර්දේසයක් => නිර්දේශයක්
නිර්දේසයන්ට => නිර්දේශයන්ට
නිර්දේසවලට => නිර්දේශවලට
නිර්දේසිත => නිර්දේශිත
නිර්දෝසී => නිර්දෝෂී
නිර්බීත => නිර්භීත
නිර්මාන => නිර්මාණ
නිර්මානකරුවන් => නිර්මාණකරුවන්
නිර්මානකරුවන්ට => නිර්මාණකරුවන්ට
නිර්මානකරුවෙකු => නිර්මාණකරුවෙකු
නිර්මානය => නිර්මාණය
නිර්මානයවීමට => නිර්මාණයවීමට
නිරාකරනය => නිරාකරණය
නිරාවරනය => නිරාවරණය
නිරාසා => නිරාෂා
නිරික්සකයින් => නිරික්ෂකයින්
නිරික්සණ => නිරික්ෂණ
නිරික්ෂන => නිරික්ෂණ
නිරීක්සකයින් => නිරීක්ෂකයින්
නිරීක්සණ => නිරීක්ෂණ
නිරීක්ෂන => නිරීක්ෂණ
නිරීක්සණය => නිරීක්ෂණය
නිරීක්ෂනය => නිරීක්ෂණය
නිරීක්සණයක => නිරීක්ෂණයක
නිරීක්ෂනයක => නිරීක්ෂණයක
නිරීක්සණයකට => නිරීක්ෂණයකට
නිරීක්ෂනයකට => නිරීක්ෂණයකට
නිරීක්සණයට => නිරීක්ෂණයට
නිරීක්ෂනයට => නිරීක්ෂණයට
නිරීක්සනය => නිරීක්ෂනය
නිරුපනය => නිරුපණය
නිරෝසන් => නිරෝෂන්
නිලදරයෙක් => නිලධරයෙක්
නිලදාරි => නිලධාරි
නිලදාරිණි => නිලධාරිණි
නිලධාරිනි => නිලධාරිණි
නිලදාරිණිය => නිලධාරිණිය
නිලධාරිනිය => නිලධාරිණිය
නිලදාරිණියගේ => නිලධාරිණියගේ
නිලධාරිනියගේ => නිලධාරිණියගේ
නිලදාරින් => නිලධාරින්
නිලදාරින්ගේ => නිලධාරින්ගේ
නිලදාරින්ට => නිලධාරින්ට
නිලදාරින්ටද => නිලධාරින්ටද
නිලදාරිනි => නිලධාරිනි
නිලදාරිනිය => නිලධාරිනිය
නිලදාරිනියක් => නිලධාරිනියක්
නිලදාරිනියන්ට => නිලධාරිනියන්ට
නිලදාරිනියන්ද => නිලධාරිනියන්ද
නිලදාරිනී => නිලධාරිනී
නිලදාරියා => නිලධාරියා
නිලදාරියාට => නිලධාරියාට
නිලදාරියෙක් => නිලධාරියෙක්
නිලදාරියෙකු => නිලධාරියෙකු
නිලදාරියෙකුගෙන් => නිලධාරියෙකුගෙන්
නිලදාරියෙකුගේ => නිලධාරියෙකුගේ
නිලදාරියෙකුට => නිලධාරියෙකුට
නිලදාරිවරයා => නිලධාරිවරයා
නිලදාරිවරයාට => නිලධාරිවරයාට
නිලදාරී => නිලධාරී
නිලදාරීන් => නිලධාරීන්
නිලදාරීන්ගෙන් => නිලධාරීන්ගෙන්
නිලදාරීන්ගේ => නිලධාරීන්ගේ
නිලදාරීන්ට => නිලධාරීන්ට
නිලදාරීන්ද => නිලධාරීන්ද
නිලදාරීන්ව => නිලධාරීන්ව
නිලදාරීන්වද => නිලධාරීන්වද
නිලදාරීවරයා => නිලධාරීවරයා
නිලදාරීවරයෙකු => නිලධාරීවරයෙකු
නිවර්තන => නිවර්ථන
නිවසආර්තිකය => නිවසආර්ථිකය
නිවාරන => නිවාරණ
නිවාරනය => නිවාරණය
නිස්ක්රීය => නිශ්ක්රීය
නිස්කී්රය => නිශ්කී්රය
නිස්චිත => නිශ්චිත
නිස්චිතව => නිශ්චිතව
නිස්ප්රභ => නිශ්ප්රභ
නිශ්ප්රබ => නිශ්ප්රභ
නිස්ප්රභා => නිශ්ප්රභා
නිශ්ප්රබා => නිශ්ප්රභා
නිස්සංක => නිශ්ශංක
නිස්සංක => නිශ්ශංක
නිස්සබ්දතාවයක් => නිශ්ශබ්දතාවයක්
නිස්සබ්දතාවයක් => නිශ්ශබ්දතාවයක්
නිසාන්ත => නිශාන්ත
නිසාන්තගෙන් => නිශාන්තගෙන්
නිසාමුදීන් => නිශාමුදීන්
නිසාරා => නිශාරා
නිස්ක්රිය => නිෂ්ක්රිය
නිස්ක්රීය => නිෂ්ක්රීය
නිස්චල => නිෂ්චල
නිස්ප්රභ => නිෂ්ප්රභ
නිෂ්ප්රබ => නිෂ්ප්රභ
නිස්ප්රභා => නිෂ්ප්රභා
නිෂ්ප්රබා => නිෂ්ප්රභා
නිස්පාදන => නිෂ්පාදන
නිස්පාදනය => නිෂ්පාදනය
නිස්පාදනයට => නිෂ්පාදනයට
නිස්පාදනයේ => නිෂ්පාදනයේ
නිස්පාදනයේදී => නිෂ්පාදනයේදී
නිස්පාදනවල => නිෂ්පාදනවල
නිස්පාදනවලට => නිෂ්පාදනවලට
නිස්පාදිත => නිෂ්පාදිත
නිස්පාදිතය => නිෂ්පාදිතය
නිසේධ => නිෂේධ
නිෂේද => නිෂේධ
නිල => නිළ
නිලදාරියෙක් => නිළදාරියෙක්
නිලධාරි => නිළධාරි
නිළදාරි => නිළධාරි
නිලධාරින් => නිළධාරින්
නිළදාරින් => නිළධාරින්
නිලධාරින්ගේ => නිළධාරින්ගේ
නිළදාරින්ගේ => නිළධාරින්ගේ
නිලධාරියෙක් => නිළධාරියෙක්
නිළදාරියෙක් => නිළධාරියෙක්
නිලධාරියෙකු => නිළධාරියෙකු
නිළදාරියෙකු => නිළධාරියෙකු
නිලධාරී => නිළධාරී
නිළදාරී => නිළධාරී
නිලධාරීන් => නිළධාරීන්
නිළදාරීන් => නිළධාරීන්
නිලධාරීන්ගේ => නිළධාරීන්ගේ
නිළදාරීන්ගේ => නිළධාරීන්ගේ
නිලධාරීන්ට => නිළධාරීන්ට
නිළදාරීන්ට => නිළධාරීන්ට
නිලමේ => නිළමේ
නිලමේවරු => නිළමේවරු
නිලි => නිළි
නීතිවිරෝදි => නීතිවිරෝධි
නීතිවිරෝදිද => නීතිවිරෝධිද
නීතිවිරෝදියි => නීතිවිරෝධියි
නීතිවිරෝදී => නීතිවිරෝධී
නීතිවිරෝදීව => නීතිවිරෝධීව
නීරීක්සණය => නීරීක්ෂණය
නීරීක්ෂනය => නීරීක්ෂණය
නීසම් => නීශම්
නුවරඑලිය => නුවරඑළිය
නුවරඑලියට => නුවරඑළියට
නුවරඑලියෙන් => නුවරඑළියෙන්
නුවරඑලියේ => නුවරඑළියේ
නුවරඑලියේදී => නුවරඑළියේදී
නෙමෙයිපලමුවෙන්ම => නෙමෙයිපළමුවෙන්ම
නෙමෙයිස්රී => නෙමෙයිශ්රී
නෙලුම් => නෙළුම්
නෙලුම්දෙණියේ => නෙළුම්දෙණියේ
නෙළුම්දෙනියේ => නෙළුම්දෙණියේ
නේත්රබිවන්දනා => නේත්රභිවන්දනා
නේත්රාබිවන්දනා => නේත්රාභිවන්දනා
නොකල => නොකළ
නොකලහොත් => නොකළහොත්
නොකලේ => නොකළේ
නොකලොත් => නොකළොත්
නොකෙරුන => නොකෙරුණ
නොකෙරුනහොත් => නොකෙරුණහොත්
නොකෙරුනු => නොකෙරුණු
නොගැලපෙන => නොගැළපෙන
නොතිබුනු => නොතිබුණු
නොතිබුනේ => නොතිබුණේ
නොනැගුනු => නොනැගුණු
නොනැවතුනු => නොනැවතුණු
නොපැමිනි => නොපැමිණි
නොපැමිනීම => නොපැමිණීම
නොපැමිනෙන => නොපැමිණෙන
නොපැමිනෙනු => නොපැමිණෙනු
නොපිරිහෙලා => නොපිරිහෙළා
නොපිලිගෙන => නොපිළිගෙන
නොපෙනෙන => නොපෙණෙන
නොලැබුනහොත් => නොලැබුණහොත්
නොලැබුනු => නොලැබුණු
නොවැලැක්විය => නොවැළැක්විය
නොවුනහොත් => නොවුණහොත්
නොවුනු => නොවුණු
නොසලකා => නොසළකා
නොලහොත් => නොළහොත්
නෞසාඩ් => නෞෂාඩ්
පංචවිද => පංචවිධ
පක්ස => පක්ෂ
පක්සග්රාහි => පක්ෂග්රාහි
පක්සග්රාහීව => පක්ෂග්රාහීව
පක්සපාත => පක්ෂපාත
පක්සපාතීත්වය => පක්ෂපාතීත්වය
පක්සපාතීව => පක්ෂපාතීව
පක්සය => පක්ෂය
පක්සයක => පක්ෂයක
පක්සයකට => පක්ෂයකට
පක්සයක් => පක්ෂයක්
පක්සයකුත් => පක්ෂයකුත්
පක්සයට => පක්ෂයට
පක්සයටයි => පක්ෂයටයි
පක්සයත් => පක්ෂයත්
පක්සයයි => පක්ෂයයි
පක්සයෙන් => පක්ෂයෙන්
පක්සයේ => පක්ෂයේ
පක්සව => පක්ෂව
පක්සවල => පක්ෂවල
පක්සවලට => පක්ෂවලට
පක්සවලටද => පක්ෂවලටද
පක්සිකයන්ගේ => පක්ෂිකයන්ගේ
පකිස්තාන => පකිස්ථාන
පකිස්තානය => පකිස්ථානය
පකිස්තානයේ => පකිස්ථානයේ
පකිස්තාන් => පකිස්ථාන්
පකිස්තානු => පකිස්ථානු
පන => පණ
පනත => පණත
පන්ඩිත => පණ්ඩිත
පනිවිඩ => පණිවිඩ
පනිවිඩය => පණිවිඩය
පනිවිඩයක් => පණිවිඩයක්
පනිවිඩයෙන් => පණිවිඩයෙන්
පනිවිඩයේ => පණිවිඩයේ
පනිවුඩය => පණිවුඩය
පනිවුඩයක් => පණිවුඩයක්
පත්කරනු => පත්කරණු
පත්කල => පත්කළ
පත්කලා => පත්කළා
පත්කලේ => පත්කළේ
පත්කෙරුනු => පත්කෙරුණු
පත්යුස => පත්යුෂ
පත්වුනා => පත්වුණා
පත්වුනේ => පත්වුණේ
පතිරන => පතිරණ
පතයට => පථයට
පතයන් => පථයන්
පදක්කම්ලාබි => පදක්කම්ලාභි
පද්දති => පද්ධති
පද්දතිය => පද්ධතිය
පද්දතියක් => පද්ධතියක්
පද්දතියකුත් => පද්ධතියකුත්
පද්දතියට => පද්ධතියට
පද්දතියත් => පද්ධතියත්
පද්දතියන් => පද්ධතියන්
පද්දතියේ => පද්ධතියේ
පද්දතීන් => පද්ධතීන්
පද්දතීන්වල => පද්ධතීන්වල
පබ්ලිසර්ස් => පබ්ලිෂර්ස්
පමන => පමණ
පමනක් => පමණක්
පමනක්ම => පමණක්ම
පමනයි => පමණයි
පමනයිඒ => පමණයිඒ
පමනි => පමණි
පමනින් => පමණින්
පරන => පරණ
පරනවිතාන => පරණවිතාන
පරමාර්තයකින් => පරමාර්ථයකින්
පර්යේසකයින් => පර්යේෂකයින්
පර්යේසණ => පර්යේෂණ
පර්යේෂන => පර්යේෂණ
පරික්සක => පරික්ෂක
පරික්සකට => පරික්ෂකට
පරික්සකවරයා => පරික්ෂකවරයා
පරික්සකවරුන් => පරික්ෂකවරුන්
පරික්සණ => පරික්ෂණ
පරික්ෂන => පරික්ෂණ
පරික්සණයක් => පරික්ෂණයක්
පරික්ෂනයක් => පරික්ෂණයක්
පරික්සන => පරික්ෂන
පරික්සවරු => පරික්ෂවරු
පරික්සා => පරික්ෂා
පරික්සාවකදී => පරික්ෂාවකදී
පරික්සාවක් => පරික්ෂාවක්
පරික්සාවට => පරික්ෂාවට
පරික්සාවේදි => පරික්ෂාවේදි
පරිගනක => පරිගණක
පරිගනකයක් => පරිගණකයක්
පරිගනකයේ => පරිගණකයේ
පරිගනයක් => පරිගණයක්
පරිගණක => පරිඝණක
පරිඝනක => පරිඝණක
පරිගණකය => පරිඝණකය
පරිඝනකය => පරිඝණකය
පරිගණකයේ => පරිඝණකයේ
පරිඝනකයේ => පරිඝණකයේ
පරිගනක => පරිඝනක
පරිගනයක්ද => පරිඝනයක්ද
පරිත්රාන => පරිත්රාණ
පරිනිර්වානයත් => පරිනිර්වාණයත්
පරිපත => පරිපථ
පරිබෝජනය => පරිභෝජනය
පරිබෝජනයට => පරිභෝජනයට
පරිමාන => පරිමාණ
පරිමානයේ => පරිමාණයේ
පරිවර්තනය => පරිවර්ථනය
පරිස්ර => පරිශ්ර
පරිස්රද => පරිශ්රද
පරිස්රමයක් => පරිශ්රමයක්
පරිස්රය => පරිශ්රය
පරිස්රයක => පරිශ්රයක
පරිස්රයට => පරිශ්රයට
පරිස්රයේ => පරිශ්රයේ
පරිස්රයේද => පරිශ්රයේද
පරිස්රයේදී => පරිශ්රයේදී
පරිස්රයේදීයි => පරිශ්රයේදීයි
පරිසිලිකයින්ගේ => පරිශිලිකයින්ගේ
පරිසීලකයින් => පරිශීලකයින්
පරිසීලනය => පරිශීලනය
පරිසීලිකයින් => පරිශීලිකයින්
පරිහරන => පරිහරණ
පරිහරනය => පරිහරණය
පරීක්න => පරීක්ණ
පරීක්නයක් => පරීක්ණයක්
පරීක්ස => පරීක්ෂ
පරීක්සක => පරීක්ෂක
පරීක්සකයින් => පරීක්ෂකයින්
පරීක්සකවරයා => පරීක්ෂකවරයා
පරීක්සකවරයාගේ => පරීක්ෂකවරයාගේ
පරීක්සකවරයාට => පරීක්ෂකවරයාට
පරීක්සකවරයෙක් => පරීක්ෂකවරයෙක්
පරීක්සකවරයෙකු => පරීක්ෂකවරයෙකු
පරීක්සකවරුන් => පරීක්ෂකවරුන්
පරීක්සකවරුන්ගේ => පරීක්ෂකවරුන්ගේ
පරීක්සණ => පරීක්ෂණ
පරීක්ෂන => පරීක්ෂණ
පරීක්සණක් => පරීක්ෂණක්
පරීක්ෂනක් => පරීක්ෂණක්
පරීක්සණද => පරීක්ෂණද
පරීක්ෂනද => පරීක්ෂණද
පරීක්සණය => පරීක්ෂණය
පරීක්ෂනය => පරීක්ෂණය
පරීක්සණයකට => පරීක්ෂණයකට
පරීක්ෂනයකට => පරීක්ෂණයකට
පරීක්සණයක් => පරීක්ෂණයක්
පරීක්ෂනයක් => පරීක්ෂණයක්
පරීක්සණයක්ද => පරීක්ෂණයක්ද
පරීක්ෂනයක්ද => පරීක්ෂණයක්ද
පරීක්සණයකින් => පරීක්ෂණයකින්
පරීක්ෂනයකින් => පරීක්ෂණයකින්
පරීක්සණයට => පරීක්ෂණයට
පරීක්ෂනයට => පරීක්ෂණයට
පරීක්සණයේදී => පරීක්ෂණයේදී
පරීක්ෂනයේදී => පරීක්ෂණයේදී
පරීක්සණවල => පරීක්ෂණවල
පරීක්ෂනවල => පරීක්ෂණවල
පරීක්සණවලට => පරීක්ෂණවලට
පරීක්ෂනවලට => පරීක්ෂණවලට
පරීක්සණවලදි => පරීක්ෂණවලදි
පරීක්ෂනවලදි => පරීක්ෂණවලදි
පරීක්සණවලදී => පරීක්ෂණවලදී
පරීක්ෂනවලදී => පරීක්ෂණවලදී
පරීක්සණවලදීයි => පරීක්ෂණවලදීයි
පරීක්ෂනවලදීයි => පරීක්ෂණවලදීයි
පරීක්සණවලින් => පරීක්ෂණවලින්
පරීක්ෂනවලින් => පරීක්ෂණවලින්
පරීක්සණාගාරයක => පරීක්ෂණාගාරයක
පරීක්ෂනාගාරයක => පරීක්ෂණාගාරයක
පරීක්සා => පරීක්ෂා
පරීක්සාකට => පරීක්ෂාකට
පරීක්සාකර => පරීක්ෂාකර
පරීක්සාව => පරීක්ෂාව
පරීක්සාවක => පරීක්ෂාවක
පරීක්සාවකට => පරීක්ෂාවකට
පරීක්සාවකදී => පරීක්ෂාවකදී
පරීක්සාවකදීයි => පරීක්ෂාවකදීයි
පරීක්සාවක් => පරීක්ෂාවක්
පරීක්සාවක්ද => පරීක්ෂාවක්ද
පරීක්සාවට => පරීක්ෂාවට
පරීක්සාවන් => පරීක්ෂාවන්
පරීස්රයේම => පරීශ්රයේම
පලකල => පලකළ
පලකලා => පලකළා
පලකලේ => පලකළේ
පලවුනා => පලවුණා
පස්චාත් => පශ්චාත්
පසු => පශු
පසලොස්වක => පසළොස්වක
පසුපෙල => පසුපෙළ
පසුවුනා => පසුවුණා
පහල => පහළ
පහලටම => පහළටම
පල => පළ
පලකර => පළකර
පලකරන => පළකරන
පලකරනවා => පළකරනවා
පලකරන්නේ => පළකරන්නේ
පලකරනු => පළකරනු
පලකරමින් => පළකරමින්
පලකරයි => පළකරයි
පලකරලා => පළකරලා
පලකලේ => පළකලේ
පලකල => පළකළ
පලකල => පළකළ
පලකලා => පළකළා
පලකලා => පළකළා
පලකලේ => පළකළේ
පලකලේ => පළකළේ
පලකිරීම => පළකිරීම
පලකිරීමේ => පළකිරීමේ
පලතුරු => පළතුරු
පලදින => පළදින
පලඳින => පළඳින
පලපුරුදු => පළපුරුදු
පලමු => පළමු
පලමුව => පළමුව
පලමුවරට => පළමුවරට
පලමුවෙන් => පළමුවෙන්
පලමුවෙනි => පළමුවෙනි
පලව => පළව
පලවන => පළවන
පලවා => පළවා
පලවිපාක => පළවිපාක
පලවුණා => පළවුණා
පළවුනා => පළවුණා
පලවූ => පළවූ
පලවෙනි => පළවෙනි
පලා => පළා
පලාත => පළාත
පලාතට => පළාතට
පලාතටම => පළාතටම
පලාත් => පළාත්
පලාත්වල => පළාත්වල
පලාත්වලට => පළාත්වලට
පලාත්වලටත් => පළාත්වලටත්
පලාත්වලත් => පළාත්වලත්
පලාත්වලින් => පළාත්වලින්
පලාතෙන් => පළාතෙන්
පලාතේ => පළාතේ
පලාතේදී => පළාතේදී
පලායාම => පළායාම
පලායාමට => පළායාමට
පලාවන් => පළාවන්
පලාවිත් => පළාවිත්
පලි => පළි
පලිගැනීමක් => පළිගැනීමක්
පලිගැනීමේ => පළිගැනීමේ
පලියට => පළියට
පලුදු => පළුදු
පලුවල්ගාල => පළුවල්ගාල
ප්රංස => ප්රංශ
ප්රංසය => ප්රංශය
ප්රංසයට => ප්රංශයට
ප්රංසයේ => ප්රංශයේ
ප්රකාස => ප්රකාශ
ප්රකාසක => ප්රකාශක
ප්රකාසකයකු => ප්රකාශකයකු
ප්රකාසකයා => ප්රකාශකයා
ප්රකාසකයින් => ප්රකාශකයින්
ප්රකාසකයින්ගේ => ප්රකාශකයින්ගේ
ප්රකාසකයෙක් => ප්රකාශකයෙක්
ප්රකාසකයෙකු => ප්රකාශකයෙකු
ප්රකාසකයෙකුද => ප්රකාශකයෙකුද
ප්රකාසකවරයා => ප්රකාශකවරයා
ප්රකාසකවරයෙකු => ප්රකාශකවරයෙකු
ප්රකාසකවරුන්ද => ප්රකාශකවරුන්ද
ප්රකාසට => ප්රකාශට
ප්රකාසය => ප්රකාශය
ප්රකාසයක => ප්රකාශයක
ප්රකාසයකට => ප්රකාශයකට
ප්රකාසයක් => ප්රකාශයක්
ප්රකාසයක්ද => ප්රකාශයක්ද
ප්රකාසයකින් => ප්රකාශයකින්
ප්රකාසයට => ප්රකාශයට
ප්රකාසයටද => ප්රකාශයටද
ප්රකාසයන් => ප්රකාශයන්
ප්රකාසයන්ට => ප්රකාශයන්ට
ප්රකාසයෙකු => ප්රකාශයෙකු
ප්රකාසයෙන් => ප්රකාශයෙන්
ප්රකාසයේ => ප්රකාශයේ
ප්රකාසවරයා => ප්රකාශවරයා
ප්රකාසවල => ප්රකාශවල
ප්රකාසවලින් => ප්රකාශවලින්
ප්රකාසිකාව => ප්රකාශිකාව
ප්රකාසිකාවක => ප්රකාශිකාවක
ප්රකාසිකාවක් => ප්රකාශිකාවක්
ප්රගතසීලී => ප්රගතශීලී
ප්රගතිසීලි => ප්රගතිශීලි
ප්රගතිසීලී => ප්රගතිශීලී
ප්රගුන => ප්රගුණ
ප්රචන්කාරීව => ප්රචණ්කාරීව
ප්රචන්ඩ => ප්රචණ්ඩ
ප්රචන්ඩකාරී => ප්රචණ්ඩකාරී
ප්රචන්ඩත්වය => ප්රචණ්ඩත්වය
ප්රචාරනය => ප්රචාරණය
ප්රචාරනයක් => ප්රචාරණයක්
ප්රනාමය => ප්රණාමය
ප්රනාමයක් => ප්රණාමයක්
ප්රතික්සේප => ප්රතික්ෂේප
ප්රතික්සේප => ප්රතික්ෂේප
ප්රතිචකී්රයකරනය => ප්රතිචකී්රයකරණය
ප්රතිපක්සව => ප්රතිපක්ෂව
ප්රතිපල => ප්රතිඵල
ප්රතිපලය => ප්රතිඵලය
ප්රතිපලයක් => ප්රතිඵලයක්
ප්රතිපලයයි => ප්රතිඵලයයි
ප්රතිපලවලට => ප්රතිඵලවලට
ප්රතිබා => ප්රතිභා
ප්රතිලාබය => ප්රතිලාභය
ප්රතිවිරුද්ද => ප්රතිවිරුද්ධ
ප්රතිසතය => ප්රතිශතය
ප්රතිසතයක් => ප්රතිශතයක්
ප්රතිසෝධන => ප්රතිශෝධන
ප්රතිශෝදන => ප්රතිශෝධන
ප්රතිසංවිදාන => ප්රතිසංවිධාන
ප්රතිසංවිදානයකට => ප්රතිසංවිධානයකට
ප්රතිසංවිදානයක් => ප්රතිසංවිධානයක්
ප්රතිසංස්කරන => ප්රතිසංස්කරණ
ප්රතිසංස්කරනය => ප්රතිසංස්කරණය
ප්රතිසංස්කරනයට => ප්රතිසංස්කරණයට
ප්රතිසන්දානය => ප්රතිසන්ධානය
ප්රතම => ප්රථම
ප්රතමයෙන් => ප්රථමයෙන්
ප්රතිකාර => ප්රථිකාර
ප්රදර්සනය => ප්රදර්ශනය
ප්රදර්සනයක් => ප්රදර්ශනයක්
ප්රදර්සනයට => ප්රදර්ශනයට
ප්රදර්සනාත්මක => ප්රදර්ශනාත්මක
ප්රදේසයේ => ප්රදේශයේ
ප්රදේසවලින් => ප්රදේශවලින්
ප්රදේස => ප්රදේශ
ප්රදේසය => ප්රදේශය
ප්රදේසයක => ප්රදේශයක
ප්රදේසයකට => ප්රදේශයකට
ප්රදේසයකදී => ප්රදේශයකදී
ප්රදේසයක් => ප්රදේශයක්
ප්රදේසයට => ප්රදේශයට
ප්රදේසයටත් => ප්රදේශයටත්
ප්රදේසයන් => ප්රදේශයන්
ප්රදේසයන්ට => ප්රදේශයන්ට
ප්රදේසයෙන් => ප්රදේශයෙන්
ප්රදේසයේ => ප්රදේශයේ
ප්රදේසයේත් => ප්රදේශයේත්
ප්රදේසයේද => ප්රදේශයේද
ප්රදේසයේදි => ප්රදේශයේදි
ප්රදේසයේදී => ප්රදේශයේදී
ප්රදේසයේදීය => ප්රදේශයේදීය
ප්රදේසයේදීයි => ප්රදේශයේදීයි
ප්රදේසයේම => ප්රදේශයේම
ප්රදේසයේයි => ප්රදේශයේයි
ප්රදේසවල => ප්රදේශවල
ප්රදේසවලට => ප්රදේශවලට
ප්රදේසවලටම => ප්රදේශවලටම
ප්රදේසවලද => ප්රදේශවලද
ප්රදේසවලදි => ප්රදේශවලදි
ප්රදේසවලදී => ප්රදේශවලදී
ප්රදේසවලදීයි => ප්රදේශවලදීයි
ප්රදේසවලින් => ප්රදේශවලින්
ප්රදේසවාසියෙකු => ප්රදේශවාසියෙකු
ප්රදේසවාසීන් => ප්රදේශවාසීන්
ප්රදේසවාසීන්ගේ => ප්රදේශවාසීන්ගේ
ප්රදේසවාසීන්ට => ප්රදේශවාසීන්ට
ප්රදේසවාසීහු => ප්රදේශවාසීහු
ප්රදන => ප්රධන
ප්රදාන => ප්රධාන
ප්රදානතම => ප්රධානතම
ප්රදානත්වය => ප්රධානත්වය
ප්රදානත්වයෙන් => ප්රධානත්වයෙන්
ප්රදානම => ප්රධානම
ප්රදානයක් => ප්රධානයක්
ප්රදානයි => ප්රධානයි
ප්රදානි => ප්රධානි
ප්රදානින් => ප්රධානින්
ප්රදානින්ගේ => ප්රධානින්ගේ
ප්රදානියා => ප්රධානියා
ප්රදානියාට => ප්රධානියාට
ප්රදානියාත් => ප්රධානියාත්
ප්රදානියාද => ප්රධානියාද
ප්රදානියාව => ප්රධානියාව
ප්රදානියෙක් => ප්රධානියෙක්
ප්රදානියෙකු => ප්රධානියෙකු
ප්රදානියෙකුට => ප්රධානියෙකුට
ප්රදානී => ප්රධානී
ප්රදානීන් => ප්රධානීන්
ප්රදානීන්ගෙන් => ප්රධානීන්ගෙන්
ප්රදානීන්ගේ => ප්රධානීන්ගේ
ප්රදානීන්ට => ප්රධානීන්ට
ප්රදානීන්ද => ප්රධානීන්ද
ප්රබල => ප්රභල
ප්රබලත්වයෙන් => ප්රභලත්වයෙන්
ප්රබලයින් => ප්රභලයින්
ප්රබවයන් => ප්රභවයන්
ප්රබාකරන් => ප්රභාකරන්
ප්රබාකරන්ගේ => ප්රභාකරන්ගේ
ප්රබාත් => ප්රභාත්
ප්රබූ => ප්රභූ
ප්රබූවරුන් => ප්රභූවරුන්
ප්රබූවරුන්ගේ => ප්රභූවරුන්ගේ
ප්රමානය => ප්රමාණය
ප්රමානයක => ප්රමාණයක
ප්රමානයකට => ප්රමාණයකට
ප්රමානයක් => ප්රමාණයක්
ප්රමානයක්ද => ප්රමාණයක්ද
ප්රමානයක්දැයි => ප්රමාණයක්දැයි
ප්රමානයට => ප්රමාණයට
ප්රමානයද => ප්රමාණයද
ප්රමානයෙන් => ප්රමාණයෙන්
ප්රමානයෙන්ම => ප්රමාණයෙන්ම
ප්රමානයේ => ප්රමාණයේ
ප්රමානවත් => ප්රමාණවත්
ප්රමුක => ප්රමුඛ
ප්රමුකත්වය => ප්රමුඛත්වය
ප්රමුකතා => ප්රමුඛතා
ප්රමුකතාව => ප්රමුඛතාව
ප්රමුකතාවක් => ප්රමුඛතාවක්
ප්රමුකතාවයක් => ප්රමුඛතාවයක්
ප්රමුකව => ප්රමුඛව
ප්රමුකස්ථානය => ප්රමුඛස්ථානය
ප්රමුඛස්තානය => ප්රමුඛස්ථානය
ප්රවනතාවක් => ප්රවණතාවක්
ප්රවනතාවයක් => ප්රවණතාවයක්
ප්රවර්දන => ප්රවර්ධන
ප්රවර්දනය => ප්රවර්ධනය
ප්රවිස්ඨවී => ප්රවිෂ්ඨවී
ප්රවීන => ප්රවීණ
ප්රවීනයන් => ප්රවීණයන්
ප්රවේස => ප්රවේශ
ප්රවේසපත් => ප්රවේශපත්
ප්රවේසපත්ර => ප්රවේශපත්ර
ප්රවේසම් => ප්රවේශම්
ප්රවේසමෙන් => ප්රවේශමෙන්
ප්රවේසයක් => ප්රවේශයක්
ප්රවේසවීමට => ප්රවේශවීමට
ප්රසංසාව => ප්රශංසාව
ප්රසනයක් => ප්රශනයක්
ප්රසස්තතම => ප්රශස්තතම
ප්රස්ණ => ප්රශ්ණ
ප්රශ්න => ප්රශ්ණ
ප්රස්ණගත => ප්රශ්ණගත
ප්රශ්නගත => ප්රශ්ණගත
ප්රස්ණය => ප්රශ්ණය
ප්රශ්නය => ප්රශ්ණය
ප්රස්ණයකට => ප්රශ්ණයකට
ප්රශ්නයකට => ප්රශ්ණයකට
ප්රස්ණයක් => ප්රශ්ණයක්
ප්රශ්නයක් => ප්රශ්ණයක්
ප්රස්ණයට => ප්රශ්ණයට
ප්රශ්නයට => ප්රශ්ණයට
ප්රස්ණවලට => ප්රශ්ණවලට
ප්රශ්නවලට => ප්රශ්ණවලට
ප්රස්න => ප්රශ්න
ප්රස්නගත => ප්රශ්නගත
ප්රස්නය => ප්රශ්නය
ප්රස්නයකට => ප්රශ්නයකට
ප්රස්නයකටද => ප්රශ්නයකටද
ප්රස්නයක් => ප්රශ්නයක්
ප්රස්නයට => ප්රශ්නයට
ප්රස්නයේදී => ප්රශ්නයේදී
ප්රස්නවලට => ප්රශ්නවලට
ප්රස්නාර්ථයක් => ප්රශ්නාර්ථයක්
ප්රශ්නාර්තයක් => ප්රශ්නාර්ථයක්
ප්රස්නේ => ප්රශ්නේ
ප්රස්ය => ප්රශ්ය
ප්රසිලා => ප්රශිලා
ප්රසිද්ද => ප්රසිද්ධ
ප්රසිද්දියට => ප්රසිද්ධියට
ප්රසිද්දියේ => ප්රසිද්ධියේ
ප්ර්රදේසයේ => ප්ර්රදේශයේ
ප්රාතමික => ප්රාථමික
ප්රාද්සීය => ප්රාද්ශීය
ප්රාදේසික => ප්රාදේශික
ප්රාදේසිය => ප්රාදේශිය
ප්රාදේසීය => ප්රාදේශීය
ප්රාදේසීයවද => ප්රාදේශීයවද
ප්රාර්තනය => ප්රාර්ථනය
ප්රාර්තනා => ප්රාර්ථනා
ප්රාර්තනාවක් => ප්රාර්ථනාවක්
ප්රියදර්සන => ප්රියදර්ශන
ප්රේක්සකයින් => ප්රේක්ෂකයින්
ප්රේමසංකර් => ප්රේමශංකර්
ප්රේසණයන් => ප්රේෂණයන්
ප්රේෂනයන් => ප්රේෂණයන්
පාක්සික => පාක්ෂික
පාක්සිකයන් => පාක්ෂිකයන්
පාක්සිකයන්ට => පාක්ෂිකයන්ට
පාක්සිකයින් => පාක්ෂිකයින්
පාක්සිකයින්ට => පාක්ෂිකයින්ට
පාකිස්තාන => පාකිස්ථාන
පාකිස්තානය => පාකිස්ථානය
පාකිස්තානයෙන් => පාකිස්ථානයෙන්
පාකිස්තානයේ => පාකිස්ථානයේ
පාකිස්තානු => පාකිස්ථානු
පාන්ඩියා => පාණ්ඩියා
පාදෙනිය => පාදෙණිය
පාදෙනියට => පාදෙණියට
පාර්සව => පාර්ශව
පාර්සවකරුවා => පාර්ශවකරුවා
පාර්සවකරුවෙකු => පාර්ශවකරුවෙකු
පාර්සවය => පාර්ශවය
පාර්සවයකට => පාර්ශවයකට
පාර්සවයක් => පාර්ශවයක්
පාර්සවයකින් => පාර්ශවයකින්
පාර්සවයට => පාර්ශවයට
පාර්සවයන් => පාර්ශවයන්
පාර්සවයන්ගෙන් => පාර්ශවයන්ගෙන්
පාර්සවයන්ට => පාර්ශවයන්ට
පාර්සවයෙන් => පාර්ශවයෙන්
පාර්සවයේ => පාර්ශවයේ
පාර්සවවල => පාර්ශවවල
පාර්සවවලට => පාර්ශවවලට
පාර්සවිය => පාර්ශවිය
පාර්සවීය => පාර්ශවීය
පාර්ස්ව => පාර්ශ්ව
පාර්ස්වකරුවන්ගෙන් => පාර්ශ්වකරුවන්ගෙන්
පාර්ස්වය => පාර්ශ්වය
පාර්ස්වයක් => පාර්ශ්වයක්
පාර්ස්වයට => පාර්ශ්වයට
පාර්ස්වයන් => පාර්ශ්වයන්
පාර්ස්වයන්ගෙන් => පාර්ශ්වයන්ගෙන්
පාර්ස්වයන්ට => පාර්ශ්වයන්ට
පාර්ස්වයෙන් => පාර්ශ්වයෙන්
පාර්ස්වයේ => පාර්ශ්වයේ
පාර්ස්වවල => පාර්ශ්වවල
පාර්ස්වවලට => පාර්ශ්වවලට
පාර්ස්වවලින් => පාර්ශ්වවලින්
පාරිබෝගික => පාරිභෝගික
පාරිබෝගිකයන් => පාරිභෝගිකයන්
පාරිබෝගිකයන්ගෙන් => පාරිභෝගිකයන්ගෙන්
පාරිබෝගිකයන්ගේ => පාරිභෝගිකයන්ගේ
පාරිබෝගිකයන්ට => පාරිභෝගිකයන්ට
පාරිබෝගිකයාට => පාරිභෝගිකයාට
පාරිබෝගිකයින් => පාරිභෝගිකයින්
පාරිබෝගිකයින්ගෙන් => පාරිභෝගිකයින්ගෙන්
පාරිබෝගිකයින්ගේ => පාරිභෝගිකයින්ගේ
පාරිබෝගිකයින්ට => පාරිභෝගිකයින්ට
පාරිබෝජනයට => පාරිභෝජනයට
පාලනාදිකාරිය => පාලනාධිකාරිය
පාලනාදිකාරියක් => පාලනාධිකාරියක්
පාලනාදිකාරියට => පාලනාධිකාරියට
පාවුලු => පාවුළු
පාලක => පාළක
පාලනයකට => පාළනයකට
පාලම => පාළම
පැමින => පැමිණ
පැමිනයා => පැමිණයා
පැමිනවීම => පැමිණවීම
පැමිනි => පැමිණි
පැමිනිම => පැමිණිම
පැමිනිමක් => පැමිණිමක්
පැමිනිමට => පැමිණිමට
පැමිනිමෙන් => පැමිණිමෙන්
පැමිනිමේ => පැමිණිමේ
පැමිනිය => පැමිණිය
පැමිනියත් => පැමිණියත්
පැමිනියා => පැමිණියා
පැමිනියේ => පැමිණියේ
පැමිනිල => පැමිණිල
පැමිනිල්ල => පැමිණිල්ල
පැමිනිල්ලකට => පැමිණිල්ලකට
පැමිනිල්ලක් => පැමිණිල්ලක්
පැමිනිල්ලක්ම => පැමිණිල්ලක්ම
පැමිනිල්ලට => පැමිණිල්ලට
පැමිනිල්ලෙන් => පැමිණිල්ලෙන්
පැමිනිලි => පැමිණිලි
පැමිනිලිකර => පැමිණිලිකර
පැමිනිලිකරුවන් => පැමිණිලිකරුවන්
පැමිනිලිකරුවන්ට => පැමිණිලිකරුවන්ට
පැමිනිලිකරුවෝ => පැමිණිලිකරුවෝ
පැමිනිලිකාර => පැමිණිලිකාර
පැමිනිලිකාරියන්ගේ => පැමිණිලිකාරියන්ගේ
පැමිනිලිවල => පැමිණිලිවල
පැමිනිලිවලට => පැමිණිලිවලට
පැමිනිවලින් => පැමිණිවලින්
පැමිනිළි => පැමිණිළි
පැමිණිලි => පැමිණිළි
පැමිනී => පැමිණී
පැමිනීම => පැමිණීම
පැමිනීමට => පැමිණීමට
පැමිනීමටද => පැමිණීමටද
පැමිනීමටයි => පැමිණීමටයි
පැමිනීමෙන් => පැමිණීමෙන්
පැමිනීමේ => පැමිණීමේ
පැමිනීමේදී => පැමිණීමේදී
පැමිනීයේද => පැමිණීයේද
පැමිනීල්ලක් => පැමිණීල්ලක්
පැමිනීලි => පැමිණීලි
පැමිනෙන => පැමිණෙන
පැමිනෙන්නන්ගෙන් => පැමිණෙන්නන්ගෙන්
පැමිනෙන්නේ => පැමිණෙන්නේ
පැමිනෙන්නේදැයි => පැමිණෙන්නේදැයි
පැමිනෙනු => පැමිණෙනු
පැමිනෙමින් => පැමිණෙමින්
පැමිනෙයි => පැමිණෙයි
පැමිනේ => පැමිණේ
පැරනි => පැරණි
පැරනිතම => පැරණිතම
පැරදුනත් => පැරදුණත්
පැරැනි => පැරැණි
පැරිසුට් => පැරිෂුට්
පැවත්වුනා => පැවත්වුණා
පැවතුන => පැවතුණ
පැවතුනහොත් => පැවතුණහොත්
පැවතුනා => පැවතුණා
පැවතුනු => පැවතුණු
පැවැත්වුනා => පැවැත්වුණා
පැවැත්වුනි => පැවැත්වුණි
පැවැත්වුනු => පැවැත්වුණු
පැවැත්වුනේ => පැවැත්වුණේ
පැහැදිලි => පැහැදිළි
පැහැදිලිව => පැහැදිළිව
පැල => පැළ
පැලක් => පැළක්
පැලද => පැළද
පැලදීම => පැළදීම
පැලදුම් => පැළදුම්
පැලඳ => පැළඳ
පැලඳි => පැළඳි
පැලඳීම => පැළඳීම
පැලඳීමද => පැළඳීමද
පැලඳීමෙන් => පැළඳීමෙන්
පැලඳුමක් => පැළඳුමක්
පැලයක් => පැළයක්
පැලැක් => පැළැක්
පැලැන්ද => පැළැන්ද
පිටපලාත්වලින් => පිටපළාත්වලින්
පිනිස => පිණිස
පිනිසයි => පිණිසයි
පිතිකරන => පිතිකරණ
පිතිකරනයෙන් => පිතිකරණයෙන්
පිතිහරබය => පිතිහරඹය
පිතිහරබයක => පිතිහරඹයක
පිබුරුපත් => පිඹුරුපත්
පියලි => පියළි
පිරිනැමුනා => පිරිනැමුණා
පිරිනැමුනු => පිරිනැමුණු
පිරිසිදුබාවය => පිරිසිදුභාවය
පිරුනු => පිරුණු
පිල => පිළ
පිලට => පිළට
පිලිකා => පිළිකා
පිලිකාවක් => පිළිකාවක්
පිලිකුල් => පිළිකුල්
පිලිකුල්ව => පිළිකුල්ව
පිලිගත => පිළිගත
පිලිගත් => පිළිගත්
පිලිගත්තා => පිළිගත්තා
පිලිගත්තේ => පිළිගත්තේ
පිලිගන්න => පිළිගන්න
පිලිගන්නවා => පිළිගන්නවා
පිලිගන්නා => පිළිගන්නා
පිලිගන්වමින් => පිළිගන්වමින්
පිලිගනිති => පිළිගනිති
පිලිගනිමින් => පිළිගනිමින්
පිලිගනියි => පිළිගනියි
පිලිගනී => පිළිගනී
පිලිගනු => පිළිගනු
පිලිගැන්වීම => පිළිගැන්වීම
පිලිගැනිම => පිළිගැනිම
පිලිගැනීම => පිළිගැනීම
පිලිගැනීමක් => පිළිගැනීමක්
පිලිගැනීමට => පිළිගැනීමට
පිලිගැනීම් => පිළිගැනීම්
පිලිගැනීමෙන් => පිළිගැනීමෙන්
පිලිගැනීමේ => පිළිගැනීමේ
පිලිගෙන => පිළිගෙන
පිලිතුර => පිළිතුර
පිලිතුරක් => පිළිතුරක්
පිලිතුරු => පිළිතුරු
පිලිනොගන්නා => පිළිනොගන්නා
පිලිඳව => පිළිඳව
පිලිපදිනවානම් => පිළිපදිනවානම්
පිලිපැදිය => පිළිපැදිය
පිලිපැඳ => පිළිපැඳ
පිලිබ => පිළිබ
පිලිබද => පිළිබද
පිලිබදව => පිළිබදව
පිලිබදවද => පිළිබදවද
පිලිබදවයි => පිළිබදවයි
පිලිබඳ => පිළිබඳ
පිලිබඳත් => පිළිබඳත්
පිලිබඳව => පිළිබඳව
පිලිබඳවත් => පිළිබඳවත්
පිලිබඳවද => පිළිබඳවද
පිලිබඳවයි => පිළිබඳවයි
පිලිම => පිළිම
පිලිමවලට => පිළිමවලට
පිලිඹිබු => පිළිඹිබු
පිළිබිබු => පිළිඹිබු
පිලිඹුවන => පිළිඹුවන
පිළිබුවන => පිළිඹුවන
පිලියන්දල => පිළියන්දල
පිලියම් => පිළියම්
පිලියෙල => පිළියෙල
පිලිවෙත => පිළිවෙත
පිලිවෙතක් => පිළිවෙතක්
පිලිවෙල => පිළිවෙල
පිලිවෙලක් => පිළිවෙලක්
පිලිවෙලින් => පිළිවෙලින්
පිලිවෙලක් => පිළිවෙළක්
පිලිවෙලක් => පිළිවෙළක්
පිලිසකර => පිළිසකර
පිලිස්සුම් => පිළිස්සුම්
පිලිසිඳ => පිළිසිඳ
පිලිිගෙන => පිළිිගෙන
පි්රයදර්සන => පි්රයදර්ශන
පිිලිතුරු => පිිළිතුරු
පුනර්ජනනීය => පුණර්ජනණීය
පුනර්ජනනීය => පුණර්ජනණීය
පුනරුත්තාපනය => පුණරුත්තාපනය
පුන්ය => පුණ්ය
පුතනුවන් => පුතණුවන්
පුනරුත්තාපන => පුනරුත්ථාපන
පුනරුත්තාපනය => පුනරුත්ථාපනය
පුපුරන => පුපුරණ
පුරවැසිබාවය => පුරවැසිභාවය
පුර්න => පුර්ණ
පුරාන => පුරාණ
පුස්ප => පුෂ්ප
පුස්පකුමාර => පුෂ්පකුමාර
පුස්පමාල් => පුෂ්පමාල්
පුස්පමිත්ර => පුෂ්පමිත්ර
පුස්පා => පුෂ්පා
පුස්පාරාම => පුෂ්පාරාම
පුස්පෝපාහාර => පුෂ්පෝපාහාර
පුහුනු => පුහුණු
පුහුනුකරු => පුහුණුකරු
පුහුනුකරුවන් => පුහුණුකරුවන්
පුහුනුකරුවන්ද => පුහුණුකරුවන්ද
පුහුනුකරුවෙකු => පුහුණුකරුවෙකු
පුහුනුව => පුහුණුව
පුහුනුවකට => පුහුණුවකට
පුහුනුවක් => පුහුණුවක්
පුහුනුවකින් => පුහුණුවකින්
පුහුනුවද => පුහුණුවද
පුහුනුවන => පුහුණුවන
පුහුනුවීම් => පුහුණුවීම්
පුහුනුවීම්වලදී => පුහුණුවීම්වලදී
පුහුනුවෙන් => පුහුණුවෙන්
පුහුනුවේදි => පුහුණුවේදි
පුහුනුවේදී => පුහුණුවේදී
පුලුල් => පුළුල්
පුලුවන් => පුළුවන්
පුලුවන්කම => පුළුවන්කම
පුලුවන්කමක් => පුළුවන්කමක්
පුලුවන්ද => පුළුවන්ද
පුලුවන්නේ => පුළුවන්නේ
පුලුස්සා => පුළුස්සා
පූර්න => පූර්ණ
පූර්නය => පූර්ණය
පූර්වබාග => පූර්වභාග
පූර්වාදර්සයක් => පූර්වාදර්ශයක්
පෘතග්ජනයෙක් => පෘථග්ජනයෙක්
පෘතිවිය => පෘථිවිය
පෘතිවියට => පෘථිවියට
පෘතිවියෙන් => පෘථිවියෙන්
පෘතිවියේ => පෘථිවියේ
පෙනහලු => පෙනහළු
පෙනුනා => පෙනුණා
පෙරමුන => පෙරමුණ
පෙරමුනක් => පෙරමුණක්
පෙරමුනට => පෙරමුණට
පෙරමුනද => පෙරමුණද
පෙරමුනයි => පෙරමුණයි
පෙරමුනු => පෙරමුණු
පෙරමුනෙන් => පෙරමුණෙන්
පෙරමුනේ => පෙරමුණේ
පෙරමුනේ => පෙරමුණේ
පෙරමුනේම => පෙරමුණේම
පෙරලා => පෙරළා
පෙරලිකාර => පෙරළිකාර
පෙරලිය => පෙරළිය
පෙරලියක් => පෙරළියක්
පෙරලියත් => පෙරළියත්
පෙරලියේදී => පෙරළියේදී
පෙරලීමට => පෙරළීමට
පෙල => පෙළ
පෙලක් => පෙළක්
පෙලගස්වන => පෙළගස්වන
පෙලපත් => පෙළපත්
පෙලපාලි => පෙළපාලි
පෙලපොත් => පෙළපොත්
පෙලපොත්වල => පෙළපොත්වල
පෙලඹවීම => පෙළඹවීම
පෙළබවීම => පෙළඹවීම
පෙලඹී => පෙළඹී
පෙළබී => පෙළඹී
පෙලඹෙන්නේ => පෙළඹෙන්නේ
පෙළබෙන්නේ => පෙළඹෙන්නේ
පෙලින් => පෙළින්
පෙලෙන => පෙළෙන
පෙලේ => පෙළේ
පෙලේ => පෙළේ
පේරාදෙනිය => පේරාදෙණිය
පේරාදෙනියේ => පේරාදෙණියේ
පේරාදෙනියේත් => පේරාදෙණියේත්
පේරාදේනිය => පේරාදේණිය
පේසල => පේෂල
පේ්රක්සකයින් => පේ්රක්ෂකයින්
පේ්රක්සකයින්ගේ => පේ්රක්ෂකයින්ගේ
පොකුන => පොකුණ
පොඩිමැනිකේ => පොඩිමැණිකේ
පොලිස්තානයේ => පොලිස්ථානයේ
පොලිස්පතිදුරයේ => පොලිස්පතිධුරයේ
පොලිස්පතිදූරය => පොලිස්පතිධූරය
පොලිස්පතිදූරයට => පොලිස්පතිධූරයට
පොල => පොළ
පොලඹවාලිය => පොළඹවාලිය
පොළබවාලිය => පොළඹවාලිය
පොලේ => පොළේ
පොලේද => පොළේද
පොලොන්නරුව => පොළොන්නරුව
පොලොවේ => පොළොවේ
පෝසක => පෝෂක
පෝසකවල => පෝෂකවල
පෝසණ => පෝෂණ
පෝෂන => පෝෂණ
පෝසණය => පෝෂණය
පෝෂනය => පෝෂණය
පෝසණවේදීන් => පෝෂණවේදීන්
පෝෂනවේදීන් => පෝෂණවේදීන්
පෝලිමේ => පෝළිමේ
පෞද්ගලීකරනය => පෞද්ගලීකරණය
පෞරානික => පෞරාණික
පල => ඵල
පලදායී => ඵලදායී
බංගදෙනිය => බංගදෙණිය
බංගලාදේසය => බංගලාදේශය
බංග්ලාද්ස => බංග්ලාද්ශ
බංග්ලාදේස => බංග්ලාදේශ
බංග්ලාදේසය => බංග්ලාදේශය
බංග්ලාදේසයට => බංග්ලාදේශයට
බංග්ලාදේසයද => බංග්ලාදේශයද
බංග්ලාදේසයේ => බංග්ලාදේශයේ
බනක් => බණක්
බන්ඩාර => බණ්ඩාර
බන්ඩාරගම => බණ්ඩාරගම
බන්ඩාරගෙන් => බණ්ඩාරගෙන්
බන්ඩාරනායක => බණ්ඩාරණායක
බන්ඩාරනායක => බණ්ඩාරණායක
බන්ඩාරනායක => බණ්ඩාරනායක
බන්ඩාරවෙල => බණ්ඩාරවෙල
බන්ඩාරවෙලට => බණ්ඩාරවෙලට
බන්ඩාරවෙලදී => බණ්ඩාරවෙලදී
බන්ඩාරිගොඩ => බණ්ඩාරිගොඩ
බද්ද => බද්ධ
බදා => බධා
බන්ඩාරනායක => බන්ඩාරණායක
බන්දනාගාර => බන්ධනාගාර
බන්දනාගාරගත => බන්ධනාගාරගත
බන්දනාගාරගතව => බන්ධනාගාරගතව
බන්දනාගාරය => බන්ධනාගාරය
බන්දනාගාරයක => බන්ධනාගාරයක
බන්දනාගාරයට => බන්ධනාගාරයට
බන්දනාගාරයන්හි => බන්ධනාගාරයන්හි
බන්දනාගාරයෙන් => බන්ධනාගාරයෙන්
බන්දනාගාරයේ => බන්ධනාගාරයේ
බන්දනාගාරයේදීම => බන්ධනාගාරයේදීම
බන්දනාගාරවල => බන්ධනාගාරවල
බන්දනාගාරවලට => බන්ධනාගාරවලට
බන්දානාගාර => බන්ධානාගාර
බබර => බඹර
බබරකැලේ => බඹරකැලේ
බබරුන් => බඹරුන්
බරපතල => බරපතළ
බරපතලයි => බරපතළයි
බලඇනිය => බලඇණිය
බලගණය => බලඝණය
බලඝනය => බලඝණය
බලදරයා => බලධරයා
බලදාරින් => බලධාරින්
බලදාරින්ට => බලධාරින්ට
බලදාරියා => බලධාරියා
බලදාරියාට => බලධාරියාට
බලදාරියෙකු => බලධාරියෙකු
බලදාරියෙකුගෙන්ද => බලධාරියෙකුගෙන්ද
බලදාරීන් => බලධාරීන්
බලදාරීන්ගෙන් => බලධාරීන්ගෙන්
බලදාරීන්ගේ => බලධාරීන්ගේ
බලදාරීන්ට => බලධාරීන්ට
බලප්රදේසය => බලප්රදේශය
බලප්රදේසයට => බලප්රදේශයට
බලප්රදේසයේ => බලප්රදේශයේ
බලප්රදේසවලට => බලප්රදේශවලට
බලමන්ඩලය => බලමණ්ඩලය
බලසක්ති => බලශක්ති
බලසක්තිය => බලශක්තිය
බසීර් => බෂීර්
බසීර්ගේ => බෂීර්ගේ
බස්රත => බස්රථ
බස්රතවල => බස්රථවල
බස්රතවලට => බස්රථවලට
බස්රතවලින් => බස්රථවලින්
බහුදින => බහුධින
බහුවිද => බහුවිධ
බල => බළ
බලකා => බළකා
බලකාය => බළකාය
බලකායට => බළකායට
බලකායේ => බළකායේ
බ්රාහ්මනයින් => බ්රාහ්මණයින්
බාද => බාධ
බාදක => බාධක
බාදකයක => බාධකයක
බාදකයකදී => බාධකයකදී
බාදකයේ => බාධකයේ
බාදකයේදී => බාධකයේදී
බාදා => බාධා
බාදාවක් => බාධාවක්
බාදාවකින් => බාධාවකින්
බාදාවන => බාධාවන
බාලක්රිස්ණන් => බාලක්රිෂ්ණන්
බාලක්රිෂ්නන් => බාලක්රිෂ්ණන්
බැන => බැණ
බෑදෙමල => බෑදෙමළ
බිඳවැටුනු => බිඳවැටුණු
බියගුලු => බියගුළු
බිස්කෙක් => බිෂ්කෙක්
බිස්කේක් => බිෂ්කේක්
බිහිකල => බිහිකළ
බිලි => බිළි
බුද්ද => බුද්ධ
බුද්දත්වයට => බුද්ධත්වයට
බුද්දාගම => බුද්ධාගම
බුද්දි => බුද්ධි
බුද්දික => බුද්ධික
බුද්දිම => බුද්ධිම
බුද්දිමත් => බුද්ධිමත්
බුද්දිමත්ව => බුද්ධිමත්ව
බුද්දිමතුන් => බුද්ධිමතුන්
බුද්දිමව => බුද්ධිමව
බුද්දියෙන් => බුද්ධියෙන්
බුද්දී => බුද්ධී
බුදුපිලිම => බුදුපිළිම
බුදුරජානන් => බුදුරජාණන්
බුදුරාජානන් => බුදුරාජාණන්
බුවනේස්වර => බුවනේෂ්වර
බුවනේස්වර් => බුවනේෂ්වර්
බුුද්දිමතුන් => බුුද්ධිමතුන්
බෙඩ්ෆෝර්ඩ්සයර් => බෙඩ්ෆෝර්ඩ්ෂයර්
බෙන්ගාසු => බෙන්ගාෂු
බෙයර්සීට් => බෙයර්ශීට්
බොදිය => බොධිය
බෝගහකුබුර => බෝගහකුඹුර
බෝදි => බෝධි
බෝදීන් => බෝධීන්
බෝබුවල => බෝඹුවල
බෝසතානන් => බෝසතාණන්
බෞද්ද => බෞද්ධ
බෞද්දයන් => බෞද්ධයන්
බෞද්දයන්ගේ => බෞද්ධයන්ගේ
බෞද්දයින් => බෞද්ධයින්
බෞද්දාගමට => බෞද්ධාගමට
බංග => භංග
බංගත්වය => භංගත්වය
බංගය => භංගය
බංගයක් => භංගයක්
බක්තිකයන්ගෙන් => භක්තිකයන්ගෙන්
බක්තිකයින් => භක්තිකයින්
බක්තිකයින්ගෙන් => භක්තිකයින්ගෙන්
බක්තිකයින්ගේ => භක්තිකයින්ගේ
බක්තිකයෙක් => භක්තිකයෙක්
බක්තිකයෙකු => භක්තිකයෙකු
බට => භට
බටයින් => භටයින්
බටයෙක් => භටයෙක්
බද්දිය => භද්දිය
බයානක => භයානක
බයානකයි => භයානකයි
බර => භර
බවන්හිදී => භවන්හිදී
බවිතා => භවිතා
බ්රමණය => භ්රමණය
භ්රමනය => භ්රමණය
බාක්තිකයින් => භාක්තිකයින්
බාග => භාග
බාගත => භාගත
බාගයක => භාගයක
බාගයක් => භාගයක්
බාගයේ => භාගයේ
බාජනය => භාජනය
බාජනයවී => භාජනයවී
බාජනයවු => භාජනයවු
බාණ්ඩ => භාණ්ඩ
භාන්ඩ => භාණ්ඩ
බාණ්ඩාගාර => භාණ්ඩාගාර
භාන්ඩාගාර => භාණ්ඩාගාර
බාණ්ඩාගාරයේ => භාණ්ඩාගාරයේ
භාන්ඩාගාරයේ => භාණ්ඩාගාරයේ
බාණ්ඩාගාරික => භාණ්ඩාගාරික
භාන්ඩාගාරික => භාණ්ඩාගාරික
බාන්ඩ => භාන්ඩ
බානුක => භානුක
බායනක => භායනක
බාර => භාර
බාරකරු => භාරකරු
බාරකරුට => භාරකරුට
බාරකරුව => භාරකරුව
බාරකරුවන් => භාරකරුවන්
බාරකාර => භාරකාර
බාරකාරවරුන්ට => භාරකාරවරුන්ට
බාරගත => භාරගත
බාරගතහොත් => භාරගතහොත්
බාරගත් => භාරගත්
බාරගත්තා => භාරගත්තා
බාරගන්නවා => භාරගන්නවා
බාරගන්නා => භාරගන්නා
බාරගනු => භාරගනු
බාරගැනීම => භාරගැනීම
බාරගැනීමට => භාරගැනීමට
බාරගෙන => භාරගෙන
බාරතීය => භාරතීය
බාරදි => භාරදි
බාරදිය => භාරදිය
බාරදී => භාරදී
බාරදීම => භාරදීම
බාරදීමක් => භාරදීමක්
බාරදීමට => භාරදීමට
බාරදීමටයි => භාරදීමටයි
බාරදීමෙන් => භාරදීමෙන්
බාරදීලා => භාරදීලා
බාරදුන් => භාරදුන්
බාරදුන්නද => භාරදුන්නද
බාරදුන්නා => භාරදුන්නා
බාරදුන්නේ => භාරදුන්නේ
බාරදෙන => භාරදෙන
බාරදෙනු => භාරදෙනු
බාරදෙයි => භාරදෙයි
බාරයක් => භාරයක්
බාරයට => භාරයට
බාරයේ => භාරයේ
බාරයේත් => භාරයේත්
බාරයේයි => භාරයේයි
බාරව => භාරව
බාරවෙයි => භාරවෙයි
බාර්යාව => භාර්යාව
බාවනා => භාවනා
බාවනාවක් => භාවනාවක්
බාවය => භාවය
බාවයට => භාවයට
බාවයන් => භාවයන්
බාවයෙන් => භාවයෙන්
බාවිත => භාවිත
බාවිතය => භාවිතය
බාවිතයට => භාවිතයට
බාවිතයෙදී => භාවිතයෙදී
බාවිතයෙන් => භාවිතයෙන්
බාවිතයේ => භාවිතයේ
බාවිතයේදී => භාවිතයේදී
බාවිතා => භාවිතා
බාෂා => භාෂා
භාසා => භාෂා
බාෂාව => භාෂාව
භාසාව => භාෂාව
බාෂාවක් => භාෂාවක්
භාසාවක් => භාෂාවක්
බාෂාවකින් => භාෂාවකින්
භාසාවකින් => භාෂාවකින්
බාෂාවලින් => භාෂාවලින්
භාසාවලින් => භාෂාවලින්
බාෂාවෙන් => භාෂාවෙන්
භාසාවෙන් => භාෂාවෙන්
බාහිර => භාහිර
බාහිරාදිය => භාහිරාදිය
බික්ෂු => භික්ෂු
භික්සු => භික්ෂු
බික්ෂුන් => භික්ෂුන්
භික්සුන් => භික්ෂුන්
බික්ෂුන්වහන්සේලා => භික්ෂුන්වහන්සේලා
භික්සුන්වහන්සේලා => භික්ෂුන්වහන්සේලා
බික්ෂූන් => භික්ෂූන්
භික්සූන් => භික්ෂූන්
බියෙන් => භියෙන්
බුක්ති => භුක්ති
බුක්තිවිදී => භුක්තිවිදී
බුතයා => භුතයා
බුමි => භුමි
බුමිකනයක් => භුමිකනයක්
බුමිය => භුමිය
බුමියේදි => භුමියේදි
බුමියේදී => භුමියේදී
බූ => භූ
බූගත => භූගත
බූමි => භූමි
බූමිකම්පාව => භූමිකම්පාව
බූමිකම්පාවේ => භූමිකම්පාවේ
බූමිය => භූමිය
බූමියක => භූමියක
බූමියක් => භූමියක්
බූමියට => භූමියට
බූමියයි => භූමියයි
බූමියේ => භූමියේ
බේදයකින් => භේදයකින්
බේද => භේද
බේදයක් => භේදයක්
බේදයකින් => භේදයකින්
බේදයෙන් => භේදයෙන්
බෝජන => භෝජන
බෞතික => භෞතික
මංගලාරාමාදිපති => මංගලාරාමාධිපති
මංසන්දිය => මංසන්ධිය
මංසන්දියේ => මංසන්ධියේ
මංසන්දියේදී => මංසන්ධියේදී
මඩකලපුව => මඩකළපුව
මනඩලයේ => මණඩලයේ
මන්ඩපය => මණ්ඩපය
මන්ඩයේ => මණ්ඩයේ
මන්ඩල => මණ්ඩල
මන්ඩලකුඩාව => මණ්ඩලකුඩාව
මන්ඩලය => මණ්ඩලය
මන්ඩලයක => මණ්ඩලයක
මන්ඩලයකට => මණ්ඩලයකට
මන්ඩලයක් => මණ්ඩලයක්
මන්ඩලයට => මණ්ඩලයට
මන්ඩලයද => මණ්ඩලයද
මන්ඩලයන්ද => මණ්ඩලයන්ද
මන්ඩලයමගින් => මණ්ඩලයමගින්
මන්ඩලයෙන් => මණ්ඩලයෙන්
මන්ඩලයේ => මණ්ඩලයේ
මන්ඩලයේදී => මණ්ඩලයේදී
මන්ඩලයේදීද => මණ්ඩලයේදීද
මන්ඩලවලින් => මණ්ඩලවලින්
මන්්ඩල => මණ්්ඩල
මන්්ඩලයේදී => මණ්්ඩලයේදී
මතදාරියෙකු => මතධාරියෙකු
මතබේද => මතභේද
මතබේදකාරී => මතභේදකාරී
මතබේදය => මතභේදය
මතබේදයක් => මතභේදයක්
මතබේදයට => මතභේදයට
මතබේදයන් => මතභේදයන්
මතබේදයෙන් => මතභේදයෙන්
මතබේදාත්මක => මතභේදාත්මක
මතුකල => මතුකළ
මද්දුමබන්ඩාර => මද්දුමබණ්ඩාර
මදුස් => මදුෂ්
මදූස් => මදූෂ්
මදූස්ගෙන් => මදූෂ්ගෙන්
මදූස්ගේ => මදූෂ්ගේ
මදූස්ට => මදූෂ්ට
මදූස්ව => මදූෂ්ව
මදයම => මධයම
මද්ය => මධ්ය
මද්යකාලීන => මධ්යකාලීන
මද්යම => මධ්යම
මද්යමකාරක => මධ්යමකාරක
මද්යයයේ => මධ්යයයේ
මද්යයේ => මධ්යයේ
මද්යයේයි => මධ්යයේයි
මද්යස්ත => මධ්යස්ත
මද්යස්ථ => මධ්යස්ථ
මධ්යස්ත => මධ්යස්ථ
මද්යස්ථව => මධ්යස්ථව
මධ්යස්තව => මධ්යස්ථව
මද්යස්ථාන => මධ්යස්ථාන
මධ්යස්තාන => මධ්යස්ථාන
මද්යස්ථානය => මධ්යස්ථානය
මධ්යස්තානය => මධ්යස්ථානය
මද්යස්ථානයක => මධ්යස්ථානයක
මධ්යස්තානයක => මධ්යස්ථානයක
මද්යස්ථානයක් => මධ්යස්ථානයක්
මධ්යස්තානයක් => මධ්යස්ථානයක්
මද්යස්ථානයට => මධ්යස්ථානයට
මධ්යස්තානයට => මධ්යස්ථානයට
මද්යස්ථානයෙන් => මධ්යස්ථානයෙන්
මධ්යස්තානයෙන් => මධ්යස්ථානයෙන්
මද්යස්ථානයේ => මධ්යස්ථානයේ
මධ්යස්තානයේ => මධ්යස්ථානයේ
මද්යස්ථානයේදි => මධ්යස්ථානයේදි
මධ්යස්තානයේදි => මධ්යස්ථානයේදි
මද්යස්ථානයේදී => මධ්යස්ථානයේදී
මධ්යස්තානයේදී => මධ්යස්ථානයේදී
මද්යස්ථානයේදීයි => මධ්යස්ථානයේදීයි
මධ්යස්තානයේදීයි => මධ්යස්ථානයේදීයි
මද්යස්ථානයේයි => මධ්යස්ථානයේයි
මධ්යස්තානයේයි => මධ්යස්ථානයේයි
මද්යසාර => මධ්යසාර
මද්යසාරද => මධ්යසාරද
මදුමාදව => මධුමාධව
මදුමාදව => මධුමාධව
මදුමාදවගේ => මධුමාධවගේ
මදුමාදවගේ => මධුමාධවගේ
මදුෂ් => මධුෂ්
මධුස් => මධුෂ්
මදුෂ්ගේ => මධුෂ්ගේ
මධුස්ගේ => මධුෂ්ගේ
මදූෂ් => මධූෂ්
මධූස් => මධූෂ්
මදූෂ්ගේ => මධූෂ්ගේ
මධූස්ගේ => මධූෂ්ගේ
මන්ත්රිදූරය => මන්ත්රිධූරය
මනුස්ය => මනුෂ්ය
මනුස්යත්වයට => මනුෂ්යත්වයට
මනූස => මනූෂ
මඳූස්ට => මඳූෂ්ට
මරන => මරණ
මරනය => මරණය
මරනයක් => මරණයක්
මරනයට => මරණයට
මරනවලට => මරණවලට
මර්දන => මර්ධන
මර්දනය => මර්ධනය
මර්දනයට => මර්ධනයට
මර්සල් => මර්ෂල්
මව්දේසයට => මව්දේශයට
මස් => මෂ්
මස්කෙලිය => මස්කෙළිය
මහමැතිවරන => මහමැතිවරණ
මහමැතිවරනය => මහමැතිවරණය
මහමැතිවරනයකට => මහමැතිවරණයකට
මහමැතිවරනයක් => මහමැතිවරණයක්
මහමැතිවරනයෙන් => මහමැතිවරණයෙන්
මහමැතිවරනයේ => මහමැතිවරණයේ
මහමැතිවරනයේදී => මහමැතිවරණයේදී
මහරැජින => මහරැජිණ
මහාදිකණයේ => මහාධිකණයේ
මහාධිකනයේ => මහාධිකණයේ
මහාදිකරණ => මහාධිකරණ
මහාධිකරන => මහාධිකරණ
මහාදිකරණය => මහාධිකරණය
මහාධිකරනය => මහාධිකරණය
මහාදිකරණයක් => මහාධිකරණයක්
මහාධිකරනයක් => මහාධිකරණයක්
මහාදිකරණයට => මහාධිකරණයට
මහාධිකරනයට => මහාධිකරණයට
මහාදිකරණයෙන් => මහාධිකරණයෙන්
මහාධිකරනයෙන් => මහාධිකරණයෙන්
මහාදිකරණයේ => මහාධිකරණයේ
මහාධිකරනයේ => මහාධිකරණයේ
මහාදිකරණයේදීයි => මහාධිකරණයේදීයි
මහාධිකරනයේදීයි => මහාධිකරණයේදීයි
මහාදිකරන => මහාධිකරන
මහාදිකරනය => මහාධිකරනය
මහාදිකරනයේ => මහාධිකරනයේ
මහාපරිමාන => මහාපරිමාණ
මහාබාණ්ඩාගාරයෙන් => මහාභාණ්ඩාගාරයෙන්
මහාභාන්ඩාගාරයෙන් => මහාභාණ්ඩාගාරයෙන්
මහාබාණ්ඩාගාරයේද => මහාභාණ්ඩාගාරයේද
මහාභාන්ඩාගාරයේද => මහාභාණ්ඩාගාරයේද
මහාරාස්ට්ර => මහාරාෂ්ට්ර
මහියංගනය => මහියංගණය
මහියංගනයේදී => මහියංගණයේදී
මහේස්වරන් => මහේශ්වරන්
මහේස් => මහේෂ්
මහේස්ත්රාත් => මහේෂ්ත්රාත්
මහේස්වරන් => මහේෂ්වරන්
මල => මළ
මලකඩ => මළකඩ
මලමිනී => මළමිනී
මලල => මළල
මලසිරුර => මළසිරුර
මලසිරුරූ => මළසිරුරූ
මලු => මළු
ම්ලේච්ච => ම්ලේච්ඡ
ම්ලේච්චත්වයයි => ම්ලේච්ඡත්වයයි
මාකුබුර => මාකුඹුර
මාකොල => මාකොළ
මාන්ඩලික => මාණ්ඩලික
මාදය => මාධය
මාදව => මාධව
මාද්ය => මාධ්ය
මාද්යට => මාධ්යට
මාද්යන්ගේ => මාධ්යන්ගේ
මාද්යන්හි => මාධ්යන්හි
මාද්යයක් => මාධ්යයක්
මාද්යයට => මාධ්යයට
මාද්යයන්ගේ => මාධ්යයන්ගේ
මාද්යයන්හි => මාධ්යයන්හි
මාද්යයෙන්ලු => මාධ්යයෙන්ලු
මාද්යවල => මාධ්යවල
මාද්යවලින් => මාධ්යවලින්
මාද්යවේදි => මාධ්යවේදි
මාද්යවේදින් => මාධ්යවේදින්
මාද්යවේදින්ට => මාධ්යවේදින්ට
මාද්යවේදිනියක => මාධ්යවේදිනියක
මාද්යවේදියා => මාධ්යවේදියා
මාද්යවේදියාව => මාධ්යවේදියාව
මාද්යවේදියෙක් => මාධ්යවේදියෙක්
මාද්යවේදියෙකු => මාධ්යවේදියෙකු
මාද්යවේදී => මාධ්යවේදී
මාද්යවේදීන් => මාධ්යවේදීන්
මාද්යවේදීන්ගෙන් => මාධ්යවේදීන්ගෙන්
මාද්යවේදීන්ගේ => මාධ්යවේදීන්ගේ
මාද්යවේදීන්ට => මාධ්යවේදීන්ට
මානුසීය => මානුෂීය
මානූසීය => මානූෂීය
මාමන්ඩිය => මාමණ්ඩිය
මාර්ගෝපදේස => මාර්ගෝපදේශ
මාර්ගෝපදේසනය => මාර්ගෝපදේශනය
මාර්සල් => මාර්ෂල්
මාර්සල්වරුන් => මාර්ෂල්වරුන්
මාලබේ => මාලඹේ
මාස් => මාෂ්
මාලාව => මාළාව
මාලාවක් => මාළාවක්
මාලාවේ => මාළාවේ
මාලි => මාළි
මාලිගය => මාළිගය
මාලිගයේදීයි => මාළිගයේදීයි
මාලිගාව => මාළිගාව
මාලිගාවට => මාළිගාවට
මාලු => මාළු
මැනිකක් => මැණිකක්
මැනික් => මැණික්
මැතිවරන => මැතිවරණ
මැතිවරනය => මැතිවරණය
මැතිවරනයකට => මැතිවරණයකට
මැතිවරනයකදී => මැතිවරණයකදී
මැතිවරනයක් => මැතිවරණයක්
මැතිවරනයට => මැතිවරණයට
මැතිවරනයන් => මැතිවරණයන්
මැතිවරනයෙන් => මැතිවරණයෙන්
මැතිවරනයේ => මැතිවරණයේ
මැතිවරනයේදී => මැතිවරණයේදී
මැතිවරනවලට => මැතිවරණවලට
මැරුනු => මැරුණු
මෑනියන් => මෑණියන්
මිත්රසීලීව => මිත්රශීලීව
මිනිෆිස් => මිනිෆිෂ්
මිලේච්ච => මිලේච්ඡ
මිස්ර => මිශ්ර
මිල => මිළ
මිලදී => මිළදී
මීලග => මීළග
මීලගට => මීළගට
මීලඟ => මීළඟ
මීලඟට => මීළඟට
මුකයෙන් => මුඛයෙන්
මුගුනුවටවන => මුගුණුවටවන
මුන => මුණ
මුනගැසී => මුණගැසී
මුනගැසීමට => මුණගැසීමට
මුනගැසුනා => මුණගැසුනා
මුනගැසෙන => මුණගැසෙන
මුනසිංහ => මුණසිංහ
මුතියංගන => මුතියංගණ
මුද්රන => මුද්රණ
මුද්රනය => මුද්රණය
මුද්රනාලයට => මුද්රණාලයට
මුද්රනාලයාධිපති => මුද්රණාලයාධිපති
මුද්රණාලයාදිපති => මුද්රණාලයාධිපති
මුද්රනාලයේ => මුද්රණාලයේ
මුදාහැරුනා => මුදාහැරුණා
මුදාහැරුනේ => මුදාහැරුණේ
මුරපොලක => මුරපොළක
මුරපොලවල් => මුරපොළවල්
මුරුද්දෙනියේ => මුරුද්දෙණියේ
මුලදර්ම => මුලධර්ම
මුලස්තාන => මුලස්ථාන
මුලස්තානය => මුලස්ථානය
මුලස්තානයට => මුලස්ථානයට
මුලස්තානයෙන් => මුලස්ථානයෙන්
මුලස්තානයේ => මුලස්ථානයේ
මුලස්තානයේදී => මුලස්ථානයේදී
මුලස්තානයේෙ => මුලස්ථානයේෙ
මුල්පෙල => මුල්පෙළ
මුලාස => මුලාශ
මුලාස්රය => මුලාශ්රය
මුස්ෆිකර් => මුෂ්ෆිකර්
මුහුන => මුහුණ
මුහුනට => මුහුණට
මුහුනදී => මුහුණදී
මුහුනදීම => මුහුණදීම
මුහුනදීමට => මුහුණදීමට
මුහුනදීමටත් => මුහුණදීමටත්
මුහුනදීලා => මුහුණදීලා
මුහුනදුන් => මුහුණදුන්
මුහුනපා => මුහුණපා
මුහුනපාන => මුහුණපාන
මුහුනු => මුහුණු
මුහුනුවර => මුහුණුවර
මුහුින => මුහුිණ
මුලු => මුළු
මුලුමනින්ම => මුළුමනින්ම
මුුහුන => මුුහුණ
මූලස්තාන => මූලස්ථාන
මූලස්තානය => මූලස්ථානය
මූලස්තානයට => මූලස්ථානයට
මූලස්තානයෙන් => මූලස්ථානයෙන්
මූලස්තානයේ => මූලස්ථානයේ
මූලස්තානයේදී => මූලස්ථානයේදී
මූලස්තානයේදීයි => මූලස්ථානයේදීයි
මූලස්තානයේධී => මූලස්ථානයේධී
මූලස්ථානයේදී => මූලස්ථානයේධී
මූලාස්ර => මූලාශ්ර
මූලාස්රවල => මූලාශ්රවල
මූල්ය => මූළ්ය
මේදා => මේධා
මොනරාගග => මොණරාගග
මොනරාගල => මොණරාගල
මොනරාගලදී => මොණරාගලදී
මොනරාගලදීයි => මොණරාගලදීයි
මොලකරු => මොළකරු
මොලයේ => මොළයේ
මෝසමකට => මෝෂමකට
මෝසමක් => මෝෂමක්
යතා => යථා
යතාතත්ත්වයට => යථාතත්ත්වයට
යතාතත්වයට => යථාතත්වයට
යතාර්තයට => යථාර්තයට
යතාවත් => යථාවත්
යලි => යළි
යලිත් => යළිත්
යාතාතත්වයට => යාථාතත්වයට
යාන්ත්රනය => යාන්ත්රණය
යාන්ත්රනයක් => යාන්ත්රණයක්
යාන්ත්රනයේ => යාන්ත්රණයේ
යැවුනා => යැවුණා
යැවුනු => යැවුණු
යුගලක් => යුගළක්
යුද්ද => යුද්ධ
යුද්දය => යුද්ධය
යුද්දයකට => යුද්ධයකට
යුද්දයක් => යුද්ධයක්
යුද්දයකින් => යුද්ධයකින්
යුද්දයට => යුද්ධයට
යුද්දයෙන් => යුද්ධයෙන්
යුද්දයේ => යුද්ධයේ
යුද්දයේදි => යුද්ධයේදි
යුද්දයේදී => යුද්ධයේදී
යුද => යුධ
යුවලගේ => යුවළගේ
යුස => යුෂ
යෙදුනා => යෙදුණා
යෙදුනු => යෙදුණු
යොමුකල => යොමුකළ
යෝදයා => යෝධයා
රක්සණ => රක්ෂණ
රක්ෂන => රක්ෂණ
රක්සණයක් => රක්ෂණයක්
රක්ෂනයක් => රක්ෂණයක්
රක්සා => රක්ෂා
රක්සිත => රක්ෂිත
රක්සිතය => රක්ෂිතය
රක්සිතයට => රක්ෂිතයට
රක්සිතයේ => රක්ෂිතයේ
රක්සිතවලට => රක්ෂිතවලට
රජානන් => රජාණන්
රජානන්ගේ => රජාණන්ගේ
රටතුල => රටතුළ
රනතුංග => රණතුංග
රනතුංගගේ => රණතුංගගේ
රනරාජා => රණරාජා
රනවක => රණවක
රනවකගේ => රණවකගේ
රනවිරු => රණවිරු
රනවිරුවන් => රණවිරුවන්
රනවිරුවන්ගේ => රණවිරුවන්ගේ
රනවිරුවන්ට => රණවිරුවන්ට
රනවිරුවෙකු => රණවිරුවෙකු
රනවිරුවෝ => රණවිරුවෝ
රනසිංහ => රණසිංහ
රනසිංහට => රණසිංහට
රත => රථ
රතගාලේ => රථගාලේ
රතද => රථද
රතය => රථය
රතයක => රථයක
රතයකට => රථයකට
රතයක් => රථයක්
රතයක්ද => රථයක්ද
රතයකින් => රථයකින්
රතයට => රථයට
රතයත් => රථයත්
රතයද => රථයද
රතයයි => රථයයි
රතයෙ => රථයෙ
රතයෙන් => රථයෙන්
රතයේ => රථයේ
රතවල => රථවල
රතවලට => රථවලට
රතවලින් => රථවලින්
රතවාහන => රථවාහන
රද්දොලුගම => රද්දොළුගම
රදිකා => රධිකා
රන්බාණ්ඩ => රන්භාණ්ඩ
රන්භාන්ඩ => රන්භාණ්ඩ
රම්යානි => රම්යාණි
රබෑව => රඹෑව
රබුකන => රඹුකන
රබුක්කන => රඹුක්කන
රබුක්වැල්ල => රඹුක්වැල්ල
රසීඞ් => රශීඞ්
රසිඩ් => රෂිඩ්
රසීඞ් => රෂීඞ්
රල => රළ
රලු => රළු
රලුවේ => රළුවේ
රාගවන් => රාඝවන්
රාජකරුනා => රාජකරුණා
රාජදානිය => රාජධානිය
රාජදානියේ => රාජධානියේ
රාජපක්ස => රාජපක්ෂ
රාජපක්සගෙන් => රාජපක්ෂගෙන්
රාජපක්සගේ => රාජපක්ෂගේ
රාජපක්සට => රාජපක්ෂට
රාජපක්සද => රාජපක්ෂද
රාජපක්සයි => රාජපක්ෂයි
රාජපක්සවරුන් => රාජපක්ෂවරුන්
රාජස්තාන් => රාජස්ථාන්
රාජාංගනය => රාජාංගණය
රාවන => රාවණ
රාවනා => රාවණා
රාසියක් => රාශියක්
රාස්ට්රපති => රාෂ්ට්රපති
රාසික් => රාෂික්
රැකවරන => රැකවරණ
රැකවරනය => රැකවරණය
රැස්කල => රැස්කළ
රැස්කලා => රැස්කළා
රැස්වුනා => රැස්වුණා
රැස්වුනේ => රැස්වුණේ
රැල => රැළ
රැලි => රැළි
රැලියකට => රැළියකට
රැලියකදී => රැළියකදී
රැලියක් => රැළියක්
රැුස්වුනා => රැුස්වුණා
රිසාඞ් => රිෂාඞ්
රිසාඞ්ගෙන් => රිෂාඞ්ගෙන්
රිසාඩ් => රිෂාඩ්
රිසාඩ්ගේ => රිෂාඩ්ගේ
රිසාඩ්ට => රිෂාඩ්ට
රිසාබ් => රිෂාබ්
රුක්සාන් => රුක්ෂාන්
රුක්සාන්මහේස් => රුක්ෂාන්මහේෂ්
රුක්සාන්මහේස් => රුක්ෂාන්මහේෂ්
රුදිර => රුධිර
රුදිරය => රුධිරය
රුදිරයේ => රුධිරයේ
රුහුනු => රුහුණු
රෙදිපිලි => රෙදිපිළි
රේකා => රේඛා
රේකිය => රේඛිය
රේනුක => රේණුක
රේනුකා => රේණුකා
රොටුබ => රොටුඹ
රොසාන් => රොෂාන්
රෝපනය => රෝපණය
රෝසාන් => රෝෂාන්
රෝහන => රෝහණ
රෝහනගෙන් => රෝහණගෙන්
රෝහිනී => රෝහිණී
ලක්කල => ලක්කළ
ලක්කලා => ලක්කළා
ලක්මිනි => ලක්මිණි
ලක්වුනා => ලක්වුණා
ලක්ස => ලක්ෂ
ලක්සකට => ලක්ෂකට
ලක්සණ => ලක්ෂණ
ලක්ෂන => ලක්ෂණ
ලක්සපාන => ලක්ෂපාන
ලක්සමන් => ලක්ෂමන්
ලක්සය => ලක්ෂය
ලක්සයක => ලක්ෂයක
ලක්සයක් => ලක්ෂයක්
ලක්ස්මන් => ලක්ෂ්මන්
ලක්ස්මි => ලක්ෂ්මි
ලක්සාන් => ලක්ෂාන්
ලක්සිත => ලක්ෂිත
ලක්සේගම => ලක්ෂේගම
ලකුන => ලකුණ
ලකුනකට => ලකුණකට
ලකුනත් => ලකුණත්
ලකුනු => ලකුණු
ලකුනුු => ලකුණුු
ලාංචනයේ => ලාංඡනයේ
ලාබ => ලාභ
ලාබය => ලාභය
ලාබයක් => ලාභයක්
ලාබියා => ලාභියා
ලැබිනි => ලැබිණි
ලැබුන => ලැබුණ
ලැබුනද => ලැබුණද
ලැබුනහොත් => ලැබුණහොත්
ලැබුනා => ලැබුණා
ලැබුනු => ලැබුණු
ලැබුනේ => ලැබුණේ
ලිකිත => ලිඛිත
ලිකිතව => ලිඛිතව
ලිකිතවද => ලිඛිතවද
ලිකීත => ලිඛීත
ලිපිකාරිනිය => ලිපිකාරිණිය
ලිපිකාරිනියක් => ලිපිකාරිණියක්
ලිපිලේකන => ලිපිලේඛන
ලියවුනු => ලියවුණු
ලියැවුනු => ලියැවුණු
ලූනු => ලූණු
ලූනුගම්වෙහෙර => ලූණුගම්වෙහෙර
ලූනුගල => ලූණුගල
ලේකකාධිකාරීවරයා => ලේකඛාධිකාරීවරයා
ලේකඛාදිකාරීවරයා => ලේකඛාධිකාරීවරයා
ලේකම්දූරයේ => ලේකම්ධූරයේ
ලේකකාධිකාරී => ලේඛකාධිකාරී
ලේඛකාදිකාරී => ලේඛකාධිකාරී
ලේකණ => ලේඛණ
ලේඛන => ලේඛණ
ලේකණගත => ලේඛණගත
ලේඛනගත => ලේඛණගත
ලේකණය => ලේඛණය
ලේඛනය => ලේඛණය
ලේකණයක් => ලේඛණයක්
ලේඛනයක් => ලේඛණයක්
ලේකණයට => ලේඛණයට
ලේඛනයට => ලේඛණයට
ලේකණයේ => ලේඛණයේ
ලේඛනයේ => ලේඛණයේ
ලේකන => ලේඛන
ලේකනය => ලේඛනය
ලේකනයක් => ලේඛනයක්
ලේකාධිකාරීවරයාට => ලේඛාධිකාරීවරයාට
ලේඛාදිකාරීවරයාට => ලේඛාධිකාරීවරයාට
ලෝකේස් => ලෝකේෂ්
වගාකල => වගාකළ
වතාවරනය => වතාවරණය
වතුරකුබුරේ => වතුරකුඹුරේ
වතුරුකුබුරේ => වතුරුකුඹුරේ
වදුරබ => වදුරඹ
වදක => වධක
වදය => වධය
වදයේදී => වධයේදී
වදහිංසාවට => වධහිංසාවට
වන්ද්යකරන => වන්ද්යකරණ
වන්ද්යකරනය => වන්ද්යකරණය
වන්ද්යකරනයකට => වන්ද්යකරණයකට
වන්ද්යකරනයක් => වන්ද්යකරණයක්
වන්ද්යකරනයට => වන්ද්යකරණයට
වන්ද්යාකරන => වන්ද්යාකරණ
වන්ද්යාකරනය => වන්ද්යාකරණය
වන්ද්යාකරනයකට => වන්ද්යාකරණයකට
වන්ද්යාකරනයට => වන්ද්යාකරණයට
වඳබාවයට => වඳභාවයට
වයබ => වයඹ
වයබට => වයඹට
වරකාපොල => වරකාපොළ
වර්නක => වර්ණක
වර්නකුලසූරිය => වර්ණකුලසූරිය
වර්නකුලසූරීය => වර්ණකුලසූරීය
වර්නයන් => වර්ණයන්
වර්නයෙන් => වර්ණයෙන්
වර්නසිංහ => වර්ණසිංහ
වර්තමානය => වර්ථමානය
වර්දන => වර්ධන
වර්දනය => වර්ධනය
වර්දනයක් => වර්ධනයක්
වර්ස => වර්ෂ
වර්සය => වර්ෂය
වර්සයෙන් => වර්ෂයෙන්
වර්සයේ => වර්ෂයේ
වර්සයේදි => වර්ෂයේදි
වර්සයේදී => වර්ෂයේදී
වර්සයේදීයි => වර්ෂයේදීයි
වර්සවල => වර්ෂවල
වර්සවලට => වර්ෂවලට
වර්සාපතනය => වර්ෂාපතනය
වර්සාපතනයක් => වර්ෂාපතනයක්
වර්සාපතනයත් => වර්ෂාපතනයත්
වර්සාභිසේක => වර්ෂාභිෂේක
වර්ෂාබිෂේක => වර්ෂාභිෂේක
වර්සාභිසේක => වර්ෂාභිෂේක
වර්සාව => වර්ෂාව
වර්සාවක් => වර්ෂාවක්
වර්සාවත් => වර්ෂාවත්
වර්සාවෙන් => වර්ෂාවෙන්
වසයෙන් => වශයෙන්
වසයෙන්ම => වශයෙන්ම
වසයෙනුයි => වශයෙනුයි
වස්ත්රාබරණයෙන් => වස්ත්රාභරණයෙන්
වස්ත්රාභරනයෙන් => වස්ත්රාභරණයෙන්
වස්ත්රාබරනයෙන් => වස්ත්රාභරනයෙන්
වල => වළ
වලක් => වළක්
වලක්වන => වළක්වන
වලක්වමින් => වළක්වමින්
වලක්වා => වළක්වා
වලක්වාලමින් => වළක්වාලමින්
වලක්වාලීම => වළක්වාලීම
වලක්වාලීමේ => වළක්වාලීමේ
වලකාලමින් => වළකාලමින්
වලකින => වළකින
වලකින්න => වළකින්න
වලකින්නැයි => වළකින්නැයි
වලකින්නැයිද => වළකින්නැයිද
වලදමා => වළදමා
වලල්ගොඩ => වළල්ගොඩ
වලලා => වළලා
වලාකුලු => වළාකුලු
ව්යපහරනය => ව්යපහරණය
ව්යර්ත => ව්යර්ථ
ව්යර්තවි => ව්යර්ථවි
ව්යවස්තා => ව්යවස්ථා
ව්යවස්තාදායක => ව්යවස්ථාදායක
ව්යවස්තාදායකය => ව්යවස්ථාදායකය
ව්යවස්තාදායකයේ => ව්යවස්ථාදායකයේ
ව්යවස්තානුකූලව => ව්යවස්ථානුකූලව
ව්යවස්තාව => ව්යවස්ථාව
ව්යවස්තාවට => ව්යවස්ථාවට
ව්යවස්තාවෙන් => ව්යවස්ථාවෙන්
ව්යවස්තාවේ => ව්යවස්ථාවේ
ව්යාර්ත => ව්යාර්ථ
වාකිස්ඨද => වාකිෂ්ඨද
වානිජ => වාණිජ
වාතාවරනය => වාතාවරණය
වාතාවරනයක => වාතාවරණයක
වාතාවරනයක් => වාතාවරණයක්
වාදබේද => වාදභේද
වාමාංසික => වාමාංශික
වාරනය => වාරණය
වාරනයකට => වාරණයකට
වාරනයක් => වාරණයක්
වාරනයට => වාරණයට
වාරනයේදී => වාරණයේදී
වාර්සික => වාර්ෂික
වාර්සිකව => වාර්ෂිකව
වාරියපොල => වාරියපොළ
වාසස්තාන => වාසස්ථාන
වැටහුනු => වැටහුණු
වැටුනා => වැටුණා
වැටුනු => වැටුණු
වැටුනේ => වැටුණේ
වැඩපිලිවෙලක් => වැඩපිලිවෙළක්
වැඩපිලිවලක් => වැඩපිළිවලක්
වැඩපිලිවලට => වැඩපිළිවලට
වැඩපිලිවෙල => වැඩපිළිවෙල
වැඩපිලිවෙලක => වැඩපිළිවෙලක
වැඩපිලිවෙලක් => වැඩපිළිවෙලක්
වැඩපිලිවෙලට => වැඩපිළිවෙලට
වැඩපිලිවෙල => වැඩපිළිවෙළ
වැඩපිලිවෙල => වැඩපිළිවෙළ
වැඩපිලිවෙලක් => වැඩපිළිවෙළක්
වැඩපිලිවෙලක් => වැඩපිළිවෙළක්
වැඩපිලිවෙලට => වැඩපිළිවෙළට
වැඩපිලිවෙලට => වැඩපිළිවෙළට
වැඩපිලිවෙලද => වැඩපිළිවෙළද
වැඩපිලිවෙලද => වැඩපිළිවෙළද
වැඩබාර => වැඩභාර
වැඩමුලු => වැඩමුළු
වැඩමුලුවකට => වැඩමුළුවකට
වැඩමුලුවේදී => වැඩමුළුවේදී
වැඩිකල => වැඩිකළ
වැඩිදියුනු => වැඩිදියුණු
වැඩිවසයෙන් => වැඩිවශයෙන්
වැදුනා => වැදුණා
වැදුනු => වැදුණු
වැලිඅමුන => වැලිඅමුණ
වැලකී => වැළකී
වැලද => වැළද
වැලඳගත් => වැළඳගත්
වැලඳගෙන => වැළඳගෙන
වැලඳීමේ => වැළඳීමේ
වැලැක්වීම => වැළැක්වීම
වැලැක්වීමට => වැළැක්වීමට
වැලැක්වීම් => වැළැක්වීම්
වැලැක්වීමේ => වැළැක්වීමේ
විකාසකයන්ගේ => විකාශකයන්ගේ
විකාසකයින්ගේ => විකාශකයින්ගේ
විකාසන => විකාශන
විකාසනය => විකාශනය
විකාසනයන් => විකාශනයන්
විකාසය => විකාශය
විකිනීමක් => විකිණීමක්
විකිනීමට => විකිණීමට
විකිනීමේ => විකිණීමේ
විකුනා => විකුණා
විකුනුම් => විකුණුම්
විකුනුම්කරුවන්ගේ => විකුණුම්කරුවන්ගේ
විගනකාධිපති => විගණකාධිපති
විගණකාදිපති => විගණකාධිපති
විගනනය => විගණනය
විගනනයක් => විගණනයක්
විගනනයක් => විගනණයක්
විග්නේස්වරන් => විග්නේශ්වරන්
විග්නේස්වරන් => විග්නේෂ්වරන්
විචාරනයක් => විචාරණයක්
විජයවර්දන => විජයවර්ධන
විජේගුනරත්න => විජේගුණරත්න
විජේවර්දන => විජේවර්ධන
විජේවර්දනගේ => විජේවර්ධනගේ
විජේවර්දනද => විජේවර්ධනද
විතාරන්දෙනියේ => විතාරන්දෙණියේ
විදේස => විදේශ
විදේසකයින් => විදේශකයින්
විදේසගත => විදේශගත
විදේසගතව => විදේශගතව
විදේසගතවීම => විදේශගතවීම
විදේසයන්ගෙන් => විදේශයන්ගෙන්
විදේසික => විදේශික
විදේසිකයන් => විදේශිකයන්
විදේසිකයන්ට => විදේශිකයන්ට
විදේසිකයා => විදේශිකයා
විදේසිකයින් => විදේශිකයින්
විදේසිකයින්ට => විදේශිකයින්ට
විදේසිකයෙකු => විදේශිකයෙකු
විදේසිකයෙකුට => විදේශිකයෙකුට
විදේසිය => විදේශිය
විදේසීය => විදේශීය
විදාන => විධාන
විදායක => විධායක
විදායකය => විධායකය
විදායකයට => විධායකයට
විදි => විධි
විදිමත් => විධිමත්
විදිමත්ව => විධිමත්ව
විදිවිදාන => විධිවිධාන
විදිවිදාන => විධිවිධාන
විනාස => විනාශ
විනාසය => විනාශය
විනාසයක් => විනාශයක්
විනාසයක්ද => විනාශයක්ද
විනාසයට => විනාශයට
විනාසයන් => විනාශයන්
විනාසයේ => විනාශයේ
විනිස්චකාරවරයෙකුගේ => විනිශ්චකාරවරයෙකුගේ
විපක්ස => විපක්ෂ
විපක්සනායක => විපක්ෂනායක
විපක්සනායකගේ => විපක්ෂනායකගේ
විපක්සය => විපක්ෂය
විපක්සයට => විපක්ෂයට
විපක්සයද => විපක්ෂයද
විපක්සයයි => විපක්ෂයයි
විපක්සයෙන් => විපක්ෂයෙන්
විපක්සයේ => විපක්ෂයේ
විපක්සව => විපක්ෂව
විබාග => විභාග
විබාගය => විභාගය
විබාගයක් => විභාගයක්
විබාගයකින් => විභාගයකින්
විබාගයට => විභාගයට
විබාගයේ => විභාගයේ
විබාගයේදී => විභාගයේදී
විබාහගයට => විභාහගයට
විබූෂණලාබීන්ගේ => විභූෂණලාභීන්ගේ
විභූසණලාභීන්ගේ => විභූෂණලාභීන්ගේ
විභූෂනලාභීන්ගේ => විභූෂණලාභීන්ගේ
විබූෂණලාබීන්ගේ => විභූෂණලාභීන්ගේ
විමර්සකයින් => විමර්ශකයින්
විමර්සණ => විමර්ශණ
විමර්ශන => විමර්ශණ
විමර්සණයක් => විමර්ශණයක්
විමර්ශනයක් => විමර්ශණයක්
විමර්සන => විමර්ශන
විමර්සනය => විමර්ශනය
විමර්සනයක => විමර්ශනයක
විමර්සනයකට => විමර්ශනයකට
විමර්සනයකදිය => විමර්ශනයකදිය
විමර්සනයකදී => විමර්ශනයකදී
විමර්සනයකදීයි => විමර්ශනයකදීයි
විමර්සනයක් => විමර්ශනයක්
විමර්සනයකින් => විමර්ශනයකින්
විමර්සනයට => විමර්ශනයට
විමර්සනයන් => විමර්ශනයන්
විමර්සනයෙන් => විමර්ශනයෙන්
විමර්සනයේ => විමර්ශනයේ
විමර්සනයේදී => විමර්ශනයේදී
විමර්සනවල => විමර්ශනවල
විමර්සනවලට => විමර්ශනවලට
විමර්සනවලදී => විමර්ශනවලදී
විමර්සනවලදීයි => විමර්ශනවලදීයි
විමර්සනවලින් => විමර්ශනවලින්
විමර්සණ => විමර්ෂණ
විමර්ෂන => විමර්ෂණ
විමර්සණය => විමර්ෂණය
විමර්ෂනය => විමර්ෂණය
විමර්සණයක් => විමර්ෂණයක්
විමර්ෂනයක් => විමර්ෂණයක්
විමර්සන => විමර්ෂන
විමලඥාන => විමලඥාණ
විමලදජ => විමලධජ
විමලදම්ම => විමලධම්ම
වියලි => වියළි
විරවංස => විරවංශ
විරුද්ද => විරුද්ධ
විරුද්දයි => විරුද්ධයි
විරුද්දව => විරුද්ධව
විරුද්දවන => විරුද්ධවන
විරුද්දවාදීන්ට => විරුද්ධවාදීන්ට
විරුද්දවීම => විරුද්ධවීම
විරුද්දවීමට => විරුද්ධවීමට
විරුද්දවීමටයි => විරුද්ධවීමටයි
විරෝදත => විරෝධත
විරෝදතා => විරෝධතා
විරෝදතාකරුවන් => විරෝධතාකරුවන්
විරෝදතාකරුවන්ගෙන් => විරෝධතාකරුවන්ගෙන්
විරෝදතාව => විරෝධතාව
විරෝදතාවක => විරෝධතාවක
විරෝදතාවකට => විරෝධතාවකට
විරෝදතාවකද => විරෝධතාවකද
විරෝදතාවක් => විරෝධතාවක්
විරෝදතාවක්ද => විරෝධතාවක්ද
විරෝදතාවට => විරෝධතාවට
විරෝදතාවය => විරෝධතාවය
විරෝදතාවයක => විරෝධතාවයක
විරෝදතාවයක් => විරෝධතාවයක්
විරෝදතාවයන් => විරෝධතාවයන්
විරෝදතාවයේ => විරෝධතාවයේ
විරෝදතාවයේදී => විරෝධතාවයේදී
විරෝදතාවල => විරෝධතාවල
විරෝදතාවේ => විරෝධතාවේ
විරෝදය => විරෝධය
විරෝදයක => විරෝධයක
විරෝදයක් => විරෝධයක්
විරෝදයට => විරෝධයට
විරෝදයද => විරෝධයද
විරෝදි => විරෝධි
විරෝදී => විරෝධී
විරෝදීයි => විරෝධීයි
විරෝදීව => විරෝධීව
විලාසය => විලාශය
විලාසයක් => විලාශයක්
විවිද => විවිධ
විවිදත්ව => විවිධත්ව
විවේචන => විවේඡන
විසමතා => විශමතා
විස්රමා => විශ්රමා
විස්රාම => විශ්රාම
විස්රාමික => විශ්රාමික
විස්ලේෂක => විශ්ලේෂක
විශ්ලේසක => විශ්ලේෂක
විස්ලේෂකයක් => විශ්ලේෂකයක්
විශ්ලේසකයක් => විශ්ලේෂකයක්
විස්ලේෂකයන් => විශ්ලේෂකයන්
විශ්ලේසකයන් => විශ්ලේෂකයන්
විස්ලේෂකයාට => විශ්ලේෂකයාට
විශ්ලේසකයාට => විශ්ලේෂකයාට
විස්ලේෂකයින් => විශ්ලේෂකයින්
විශ්ලේසකයින් => විශ්ලේෂකයින්
විස්ලේෂකයින්ගේ => විශ්ලේෂකයින්ගේ
විශ්ලේසකයින්ගේ => විශ්ලේෂකයින්ගේ
විස්ලේෂකයෙක් => විශ්ලේෂකයෙක්
විශ්ලේසකයෙක් => විශ්ලේෂකයෙක්
විස්ලේෂකයෙකු => විශ්ලේෂකයෙකු
විශ්ලේසකයෙකු => විශ්ලේෂකයෙකු
විස්ලේෂකවරයෙකු => විශ්ලේෂකවරයෙකු
විශ්ලේසකවරයෙකු => විශ්ලේෂකවරයෙකු
විස්ලේෂණ => විශ්ලේෂණ
විශ්ලේසණ => විශ්ලේෂණ
විශ්ලේෂන => විශ්ලේෂණ
විස්ලේෂණය => විශ්ලේෂණය
විශ්ලේසණය => විශ්ලේෂණය
විශ්ලේෂනය => විශ්ලේෂණය
විස්ලේෂණයක් => විශ්ලේෂණයක්
විශ්ලේසණයක් => විශ්ලේෂණයක්
විශ්ලේෂනයක් => විශ්ලේෂණයක්
විස්ලේෂණයන් => විශ්ලේෂණයන්
විශ්ලේසණයන් => විශ්ලේෂණයන්
විශ්ලේෂනයන් => විශ්ලේෂණයන්
විස්ව => විශ්ව
විස්වමඩු => විශ්වමඩු
විස්වවිද්යාලය => විශ්වවිද්යාලය
විස්වසනීය => විශ්වසනීය
විස්වාස => විශ්වාශ
විස්වාස => විශ්වාශ
විස්වාස => විශ්වාස
විස්වාසකළ => විශ්වාසකළ
විශ්වාසකල => විශ්වාසකළ
විස්වාසනීය => විශ්වාසනීය
විස්වාසභංග => විශ්වාසභංග
විශ්වාසබංග => විශ්වාසභංග
විස්වාසභංගය => විශ්වාසභංගය
විශ්වාසබංගය => විශ්වාසභංගය
විස්වාසභංගයකට => විශ්වාසභංගයකට
විශ්වාසබංගයකට => විශ්වාසභංගයකට
විස්වාසභංගයක් => විශ්වාසභංගයක්
විශ්වාසබංගයක් => විශ්වාසභංගයක්
විස්වාසභංගයකින් => විශ්වාසභංගයකින්
විශ්වාසබංගයකින් => විශ්වාසභංගයකින්
විස්වාසභංගයට => විශ්වාසභංගයට
විශ්වාසබංගයට => විශ්වාසභංගයට
විස්වාසභංගයෙන් => විශ්වාසභංගයෙන්
විශ්වාසබංගයෙන් => විශ්වාසභංගයෙන්
විස්වාසභංගයේ => විශ්වාසභංගයේ
විශ්වාසබංගයේ => විශ්වාසභංගයේ
විස්වාසභංගයේදී => විශ්වාසභංගයේදී
විශ්වාසබංගයේදී => විශ්වාසභංගයේදී
විස්වාසය => විශ්වාසය
විස්වාසයක් => විශ්වාසයක්
විස්වාසයට => විශ්වාසයට
විස්වාසයෙන් => විශ්වාසයෙන්
විසාරදයෝ => විශාරදයෝ
විසාල => විශාල
විසාලතම => විශාලතම
විසාලම => විශාලම
විසිෂ්ට => විශිෂ්ට
විශිස්ට => විශිෂ්ට
විසිෂ්ඨ => විශිෂ්ඨ
විශිස්ඨ => විශිෂ්ඨ
විසිෂ්ඨත්වයට => විශිෂ්ඨත්වයට
විශිස්ඨත්වයට => විශිෂ්ඨත්වයට
විසුද්ධිකරණයක් => විශුද්ධිකරණයක්
විශුද්දිකරණයක් => විශුද්ධිකරණයක්
විශුද්ධිකරනයක් => විශුද්ධිකරණයක්
විසේෂ => විශේෂ
විශේස => විශේෂ
විසේෂඥ => විශේෂඥ
විශේසඥ => විශේෂඥ
විසේෂත්වය => විශේෂත්වය
විශේසත්වය => විශේෂත්වය
විසේෂත්වයක් => විශේෂත්වයක්
විශේසත්වයක් => විශේෂත්වයක්
විසේෂයෙන් => විශේෂයෙන්
විශේසයෙන් => විශේෂයෙන්
විසේෂාංග => විශේෂාංග
විශේසාංග => විශේෂාංග
විසේෂාංගයට => විශේෂාංගයට
විශේසාංගයට => විශේෂාංගයට
විසේලේෂණය => විශේලේෂණය
විශේලේසණය => විශේලේෂණය
විශේලේෂනය => විශේලේෂණය
විසේෂ => විශේෂ
විශේස => විශේෂ
විසේෂඥ => විශේෂඥ
විශේසඥ => විශේෂඥ
විසේෂඥයන්ගෙන් => විශේෂඥයන්ගෙන්
විශේසඥයන්ගෙන් => විශේෂඥයන්ගෙන්
විසේෂඥයා => විශේෂඥයා
විශේසඥයා => විශේෂඥයා
විසේෂඥයින් => විශේෂඥයින්
විශේසඥයින් => විශේෂඥයින්
විසේෂඥයෙක් => විශේෂඥයෙක්
විශේසඥයෙක් => විශේෂඥයෙක්
විසේෂත්වය => විශේෂත්වය
විශේසත්වය => විශේෂත්වය
විසේෂත්වයක් => විශේෂත්වයක්
විශේසත්වයක් => විශේෂත්වයක්
විසේෂත්වයකි => විශේෂත්වයකි
විශේසත්වයකි => විශේෂත්වයකි
විසේෂයි => විශේෂයි
විශේසයි => විශේෂයි
විසේෂයෙන් => විශේෂයෙන්
විශේසයෙන් => විශේෂයෙන්
විසේෂයෙන්ම => විශේෂයෙන්ම
විශේසයෙන්ම => විශේෂයෙන්ම
විසේෂාංග => විශේෂාංග
විශේසාංග => විශේෂාංග
විසේෂාංගය => විශේෂාංගය
විශේසාංගය => විශේෂාංගය
විසේෂාංගයකදී => විශේෂාංගයකදී
විශේසාංගයකදී => විශේෂාංගයකදී
විසේෂාංගයට => විශේෂාංගයට
විශේසාංගයට => විශේෂාංගයට
විසේෂිත => විශේෂිත
විශේසිත => විශේෂිත
විසේෂිතවූ => විශේෂිතවූ
විශේසිතවූ => විශේෂිතවූ
විසේ්ෂ => විශේ්ෂ
විශේ්ස => විශේ්ෂ
විසමතාවක් => විෂමතාවක්
විසමතාවන්ට => විෂමතාවන්ට
විසමාචාරය => විෂමාචාරය
විසය => විෂය
විසයන් => විෂයන්
විසයභාර => විෂයභාර
විෂයබාර => විෂයභාර
විසන්දි => විසන්ධි
විසුරුවාහල => විසුරුවාහළ
විහාරස්ත => විහාරස්ථ
විහාරස්තාන => විහාරස්ථාන
විහාරස්තානය => විහාරස්ථානය
විහාරස්තානයක => විහාරස්ථානයක
විහාරස්තානයට => විහාරස්ථානයට
විහාරස්තානයෙන් => විහාරස්ථානයෙන්
විහාරස්තානයේ => විහාරස්ථානයේ
විහාරස්තානයේදී => විහාරස්ථානයේදී
විහාරස්තානයේදීයි => විහාරස්ථානයේදීයි
විහාරස්තානවල => විහාරස්ථානවල
විහාරස්තානවලට => විහාරස්ථානවලට
විහාරස්තානවලද => විහාරස්ථානවලද
විහාරස්තානවලදී => විහාරස්ථානවලදී
විහාරස්තාවනය => විහාරස්ථාවනය
විහාරස්තාවල => විහාරස්ථාවල
විහාරාදිකාරි => විහාරාධිකාරි
විහාරාදිපති => විහාරාධිපති
විහේස => විහේෂ
වීති => වීථි
වීතිවලට => වීථිවලට
වීරබන්ඩාර => වීරබණ්ඩාර
වීරවංස => වීරවංශ
වීරවංසට => වීරවංශට
වීරවංසද => වීරවංශද
වීරවංසයි => වීරවංශයි
වීරෝදි => වීරෝධි
වීරෝදී => වීරෝධී
වුන => වුණ
වුනත් => වුණත්
වුනා => වුණා
වුනානේ => වුණානේ
වුනාම => වුණාම
වුනු => වුණු
වුනේ => වුණේ
වුනේ => වුණේ
වුනොත් => වුණොත්
වූනා => වූණා
වෘක්සලතා => වෘක්ෂලතා
වෙනුවෙන් => වෙණුවෙන්
වෙන්වුනු => වෙන්වුණු
වෙරල => වෙරළ
වෙරලට => වෙරළට
වෙරලතීරයේ => වෙරළතීරයේ
වෙරලබඩ => වෙරළබඩ
වෙරලාරක්ෂක => වෙරළාරක්ෂක
වෙරළාරක්සක => වෙරළාරක්ෂක
වෙරලාරක්ෂකයින් => වෙරළාරක්ෂකයින්
වෙරළාරක්සකයින් => වෙරළාරක්ෂකයින්
වෙරලාසන්නයේ => වෙරළාසන්නයේ
වෙලඳපලට => වෙලඳපළට
වෙලද => වෙළද
වෙලදපලවල් => වෙළදපලවල්
වෙලදපොල => වෙළදපොල
වෙලදපොලේ => වෙළදපොලේ
වෙලදපොල => වෙළදපොළ
වෙලදපොල => වෙළදපොළ
වෙලදසැල => වෙළදසැල
වෙලදසැලක => වෙළදසැලක
වෙලදසැලකින් => වෙළදසැලකින්
වෙලදසැල් => වෙළදසැල්
වෙලදසැල්වල => වෙළදසැල්වල
වෙලදසැලේ => වෙළදසැලේ
වෙලදාමද => වෙළදාමද
වෙලදාම් => වෙළදාම්
වෙලදාමේ => වෙළදාමේ
වෙලදුන් => වෙළදුන්
වෙලදුන්ගේ => වෙළදුන්ගේ
වෙලඳ => වෙළඳ
වෙලඳපලට => වෙළඳපලට
වෙලඳපලේ => වෙළඳපලේ
වෙලඳපොල => වෙළඳපොල
වෙලඳපොලට => වෙළඳපොලට
වෙලඳපොලෙහි => වෙළඳපොලෙහි
වෙලඳපොලේ => වෙළඳපොලේ
වෙලඳපොලට => වෙළඳපොළට
වෙලඳපොලට => වෙළඳපොළට
වෙලඳසැලක => වෙළඳසැලක
වෙලඳසැලකටම => වෙළඳසැලකටම
වෙලඳසැලක් => වෙළඳසැලක්
වෙලඳසැල් => වෙළඳසැල්
වෙලඳසැලේ => වෙළඳසැලේ
වෙලඳාමටත් => වෙළඳාමටත්
වෙලඳාම් => වෙළඳාම්
වෙලඳුන් => වෙළඳුන්
වෙලෙදසැලක => වෙළෙදසැලක
වෙලෙදුන්ගේ => වෙළෙදුන්ගේ
වෙලෙඳ => වෙළෙඳ
වේත්රදාරී => වේත්රධාරී
වේලුපිල්ලේ => වේළුපිල්ලේ
වොක්ස්වෝල් => වොක්ෂ්වෝල්
වොසින්ටනයේ => වොෂින්ටනයේ
සංකර් => ශංකර්
සක්තිමක් => ශක්තිමක්
සක්තිමත් => ශක්තිමත්
සක්තිමත්ව => ශක්තිමත්ව
සක්තිය => ශක්තිය
සක්තියක් => ශක්තියක්
සක්තීන් => ශක්තීන්
සකීබ් => ශකීබ්
සඩාබ් => ශඩාබ්
සත => ශත
සතක => ශතක
සතකය => ශතකය
සතකයක් => ශතකයක්
සතකයයි => ශතකයයි
සන්කර් => ශන්කර්
සබ්ද => ශබ්ද
සබ්දය => ශබ්දය
සබ්දයක් => ශබ්දයක්
සබ්දවාහිනී => ශබ්දවාහිනී
සම්මි => ශම්මි
සම්සි => ශම්සි
සර්මා => ශර්මා
සර්මාට => ශර්මාට
සර්මිලා => ශර්මිලා
සර්යා => ශර්යා
සරියා => ශරියා
සරිර => ශරිර
සරීයා => ශරීයා
සරීර => ශරීර
සරීරයට => ශරීරයට
සලනි => ශලනි
සල්ය => ශල්ය
සල්යකර්මයක් => ශල්යකර්මයක්
සවේන්ද්ර => ශවේන්ද්ර
සෂි => ශෂි
ශසි => ශෂි
සෂිකුමාර් => ශෂිකුමාර්
ශසිකුමාර් => ශෂිකුමාර්
සෂිමහෙන්ද්රන් => ශෂිමහෙන්ද්රන්
ශසිමහෙන්ද්රන් => ශෂිමහෙන්ද්රන්
සෂී => ශෂී
ශසී => ශෂී
සහීන් => ශහීන්
ස්යාමල් => ශ්යාමල්
ස්යාමා => ශ්යාමා
ස්රද්ධාවෙන් => ශ්රද්ධාවෙන්
ශ්රද්දාවෙන් => ශ්රද්ධාවෙන්
ස්රම => ශ්රම
ස්රමදානයක් => ශ්රමදානයක්
ස්රමය => ශ්රමය
ස්රමයට => ශ්රමයට
ස්රමයේ => ශ්රමයේ
ස්රමික => ශ්රමික
ස්රවණය => ශ්රවණය
ශ්රවනය => ශ්රවණය
ස්රවණාගාරයේ => ශ්රවණාගාරයේ
ශ්රවනාගාරයේ => ශ්රවණාගාරයේ
ස්රවනාගාරයේදි => ශ්රවනාගාරයේදි
ස්ර්රී => ශ්ර්රී
ස්රාදුල් => ශ්රාදුල්
ස්රාවකයන් => ශ්රාවකයන්
ස්රාවකයන්ගෙන් => ශ්රාවකයන්ගෙන්
ස්රාවකයින් => ශ්රාවකයින්
ස්රාවකයින්ගේ => ශ්රාවකයින්ගේ
ස්රාවකයෙකු => ශ්රාවකයෙකු
ස්රාස්ත්රපති => ශ්රාස්ත්රපති
ස්රි => ශ්රි
ස්රිලනිපයෙන් => ශ්රිලනිපයෙන්
ස්රී => ශ්රී
ස්රීපාද => ශ්රීපාද
ස්රීපාදය => ශ්රීපාදය
ස්රීපුර => ශ්රීපුර
ස්රීමත් => ශ්රීමත්
ස්රීයෙන් => ශ්රීයෙන්
ස්රීලංකා => ශ්රීලංකා
ස්රීලංගම => ශ්රීලංගම
ස්රීලනිප => ශ්රීලනිප
ස්රීලනිපය => ශ්රීලනිපය
ස්රීලනිපයෙන් => ශ්රීලනිපයෙන්
ස්රීලනිපයේ => ශ්රීලනිපයේ
ස්රීලාල් => ශ්රීලාල්
ස්රේණිය => ශ්රේණිය
ශ්රේනිය => ශ්රේණිය
ස්රේණියට => ශ්රේණියට
ශ්රේනියට => ශ්රේණියට
ස්රේණි => ශ්රේණි
ශ්රේනි => ශ්රේණි
ස්රේණිගත => ශ්රේණිගත
ශ්රේනිගත => ශ්රේණිගත
ස්රේණිය => ශ්රේණිය
ශ්රේනිය => ශ්රේණිය
ස්රේණියට => ශ්රේණියට
ශ්රේනියට => ශ්රේණියට
ස්රේණියෙන් => ශ්රේණියෙන්
ශ්රේනියෙන් => ශ්රේණියෙන්
ස්රේණියේ => ශ්රේණියේ
ශ්රේනියේ => ශ්රේණියේ
ස්රේණිවල => ශ්රේණිවල
ශ්රේනිවල => ශ්රේණිවල
ස්රේෂ්ඨාධිකරණ => ශ්රේෂ්ඨාධිකරණ
ශ්රේස්ඨාධිකරණ => ශ්රේෂ්ඨාධිකරණ
ශ්රේෂ්ඨාදිකරණ => ශ්රේෂ්ඨාධිකරණ
ශ්රේෂ්ඨාධිකරන => ශ්රේෂ්ඨාධිකරණ
ස්රේෂ්ඨාධිකරණය => ශ්රේෂ්ඨාධිකරණය
ශ්රේස්ඨාධිකරණය => ශ්රේෂ්ඨාධිකරණය
ශ්රේෂ්ඨාදිකරණය => ශ්රේෂ්ඨාධිකරණය
ශ්රේෂ්ඨාධිකරනය => ශ්රේෂ්ඨාධිකරණය
ස්රේෂ්ඨාධිකරණයට => ශ්රේෂ්ඨාධිකරණයට
ශ්රේස්ඨාධිකරණයට => ශ්රේෂ්ඨාධිකරණයට
ශ්රේෂ්ඨාදිකරණයට => ශ්රේෂ්ඨාධිකරණයට
ශ්රේෂ්ඨාධිකරනයට => ශ්රේෂ්ඨාධිකරණයට
ස්රේෂ්ඨාධිකරණයෙන් => ශ්රේෂ්ඨාධිකරණයෙන්
ශ්රේස්ඨාධිකරණයෙන් => ශ්රේෂ්ඨාධිකරණයෙන්
ශ්රේෂ්ඨාදිකරණයෙන් => ශ්රේෂ්ඨාධිකරණයෙන්
ශ්රේෂ්ඨාධිකරනයෙන් => ශ්රේෂ්ඨාධිකරණයෙන්
ස්රේෂ්ඨාධිකරණයේ => ශ්රේෂ්ඨාධිකරණයේ
ශ්රේස්ඨාධිකරණයේ => ශ්රේෂ්ඨාධිකරණයේ
ශ්රේෂ්ඨාදිකරණයේ => ශ්රේෂ්ඨාධිකරණයේ
ශ්රේෂ්ඨාධිකරනයේ => ශ්රේෂ්ඨාධිකරණයේ
ස්රේෂ්ඨාධිකරණයේදී => ශ්රේෂ්ඨාධිකරණයේදී
ශ්රේස්ඨාධිකරණයේදී => ශ්රේෂ්ඨාධිකරණයේදී
ශ්රේෂ්ඨාදිකරණයේදී => ශ්රේෂ්ඨාධිකරණයේදී
ශ්රේෂ්ඨාධිකරනයේදී => ශ්රේෂ්ඨාධිකරණයේදී
ස්රේෂ්ඨාධිකරණයේදීයි => ශ්රේෂ්ඨාධිකරණයේදීයි
ශ්රේස්ඨාධිකරණයේදීයි => ශ්රේෂ්ඨාධිකරණයේදීයි
ශ්රේෂ්ඨාදිකරණයේදීයි => ශ්රේෂ්ඨාධිකරණයේදීයි
ශ්රේෂ්ඨාධිකරනයේදීයි => ශ්රේෂ්ඨාධිකරණයේදීයි
ස්වසන => ශ්වසන
ස්වේත => ශ්වේත
සාක්ය => ශාක්ය
සාක්යසිංහ => ශාක්යසිංහ
සාඛා => ශාඛා
ශාකා => ශාඛා
සාඛාව => ශාඛාව
ශාකාව => ශාඛාව
සාඛාවක => ශාඛාවක
ශාකාවක => ශාඛාවක
සාඛාවේ => ශාඛාවේ
ශාකාවේ => ශාඛාවේ
සානක => ශානක
සාන් => ශාන්
සාන්ත => ශාන්ත
සාන්තිය => ශාන්තිය
සානිකා => ශානිකා
සාරීරික => ශාරීරික
සාලවේ => ශාලවේ
සාලා => ශාලා
සාලාව => ශාලාව
සාලාවක => ශාලාවක
සාලාවකට => ශාලාවකට
සාලාවක් => ශාලාවක්
සාලාවට => ශාලාවට
සාලාවටද => ශාලාවටද
සාලාවේ => ශාලාවේ
සාලාවේදී => ශාලාවේදී
සාලාවේදීයි => ශාලාවේදීයි
සාසන => ශාසන
සාසනයේ => ශාසනයේ
සාසනරතන => ශාසනරතන
සාසනාරක්ෂක => ශාසනාරක්ෂක
ශාසනාරක්සක => ශාසනාරක්ෂක
සාසනික => ශාසනික
සාස්ත්ර => ශාස්ත්ර
සාහීද් => ශාහීද්
සැන්ග්රිලා => ශැන්ග්රිලා
සිකර් => ශිකර්
සික්ෂණ => ශික්ෂණ
ශික්සණ => ශික්ෂණ
ශික්ෂන => ශික්ෂණ
සිකාර්පුර් => ශිකාර්පුර්
සිබ්ලි => ශිබ්ලි
සිරන්ති => ශිරන්ති
සිරාන් => ශිරාන්
සිල්පි => ශිල්පි
සිල්පිනී => ශිල්පිනී
සිල්පියෙක් => ශිල්පියෙක්
සිල්පියෙකු => ශිල්පියෙකු
සිල්පී => ශිල්පී
සිවප්රගාසම් => ශිවප්රගාසම්
සිවමෝහන් => ශිවමෝහන්
සිවසේනා => ශිවසේනා
සිවාජිලිංගම් => ශිවාජිලිංගම්
සිවාජිලිංගම්ට => ශිවාජිලිංගම්ට
සිෂ්ටාචාර => ශිෂ්ටාචාර
ශිස්ටාචාර => ශිෂ්ටාචාර
සිෂ්ටාචාරය => ශිෂ්ටාචාරය
ශිස්ටාචාරය => ශිෂ්ටාචාරය
සිෂ්ය => ශිෂ්ය
ශිස්ය => ශිෂ්ය
සිෂ්යත්ව => ශිෂ්යත්ව
ශිස්යත්ව => ශිෂ්යත්ව
සිෂ්යන් => ශිෂ්යන්
ශිස්යන් => ශිෂ්යන්
සිෂ්යභට => ශිෂ්යභට
ශිස්යභට => ශිෂ්යභට
ශිෂ්යබට => ශිෂ්යභට
සිෂ්යයාගේ => ශිෂ්යයාගේ
ශිස්යයාගේ => ශිෂ්යයාගේ
සිෂ්යයාවගේ => ශිෂ්යයාවගේ
ශිස්යයාවගේ => ශිෂ්යයාවගේ
සිෂ්යයෙක් => ශිෂ්යයෙක්
ශිස්යයෙක් => ශිෂ්යයෙක්
සිෂ්යයෙකුව => ශිෂ්යයෙකුව
ශිස්යයෙකුව => ශිෂ්යයෙකුව
සිෂ්යා => ශිෂ්යා
ශිස්යා => ශිෂ්යා
සිෂ්යාවක් => ශිෂ්යාවක්
ශිස්යාවක් => ශිෂ්යාවක්
සිෂ්යාවක්ව => ශිෂ්යාවක්ව
ශිස්යාවක්ව => ශිෂ්යාවක්ව
සිෂ්යාවන් => ශිෂ්යාවන්
ශිස්යාවන් => ශිෂ්යාවන්
සිෂ්යාවන්ට => ශිෂ්යාවන්ට
ශිස්යාවන්ට => ශිෂ්යාවන්ට
සි්ර => ශි්ර
සීකර් => ශීකර්
සීක්ෂණ => ශීක්ෂණ
ශීක්සණ => ශීක්ෂණ
ශීක්ෂන => ශීක්ෂණ
සීතකරණයක් => ශීතකරණයක්
ශීතකරනයක් => ශීතකරණයක්
සීර්ෂ => ශීර්ෂ
ශීර්ස => ශීර්ෂ
සීර්ෂය => ශීර්ෂය
ශීර්සය => ශීර්ෂය
සීර්ෂයක් => ශීර්ෂයක්
ශීර්සයක් => ශීර්ෂයක්
සීර්ෂයයි => ශීර්ෂයයි
ශීර්සයයි => ශීර්ෂයයි
සීල => ශීල
සීලය => ශීලය
සී්ර => ශී්ර
සී්රලනිප => ශී්රලනිප
සුදතුම් => ශුදතුම්
සුද්ධ => ශුද්ධ
ශුද්ද => ශුද්ධ
සුද්ධෝත්තම => ශුද්ධෝත්තම
ශුද්දෝත්තම => ශුද්ධෝත්තම
සූද්ධ => ශූද්ධ
ශූද්ද => ශූද්ධ
සූර => ශූර
සූරතා => ශූරතා
සූරතාව => ශූරතාව
සූරයින් => ශූරයින්
සෙරිෆ් => ශෙරිෆ්
සෙරීෆ් => ශෙරීෆ්
සෙහාන් => ශෙහාන්
සේ්්රෂ්ඨාධිකරණ => ශේ්්රෂ්ඨාධිකරණ
ශේ්්රස්ඨාධිකරණ => ශේ්්රෂ්ඨාධිකරණ
ශේ්්රෂ්ඨාදිකරණ => ශේ්්රෂ්ඨාධිකරණ
ශේ්්රෂ්ඨාධිකරන => ශේ්්රෂ්ඨාධිකරණ
සෛලමය => ශෛලමය
සෝක => ශෝක
සෝකය => ශෝකය
සෝකයට => ශෝකයට
සෝකයටත් => ශෝකයටත්
සෝචනීය => ශෝචනීය
සකිබ් => ෂකිබ්
සන්මුගම් => ෂන්මුගම්
සම්මි => ෂම්මි
සර්ට් => ෂර්ට්
සර්ට්ස් => ෂර්ට්ස්
සර්මා => ෂර්මා
සර්මාට => ෂර්මාට
සරියා => ෂරියා
සරිෆ් => ෂරිෆ්
සා => ෂා
සාන් => ෂාන්
සාමි => ෂාමි
සායි => ෂායි
සැංග්රිලා => ෂැංග්රිලා
සැංගි්රලා => ෂැංගි්රලා
සැංහයි => ෂැංහයි
සැන්ග්රිලා => ෂැන්ග්රිලා
සැන්ග්රීලා => ෂැන්ග්රීලා
සැන්ගි්රලා => ෂැන්ගි්රලා
සැන්හයි => ෂැන්හයි
සිංසෝ => ෂිංසෝ
සින් => ෂින්
සින්ග්ෆේයි => ෂින්ග්ෆේයි
සින්සෝ => ෂින්සෝ
සින්හුවා => ෂින්හුවා
සියාහෝ => ෂියාහෝ
සියෝමෙන් => ෂියෝමෙන්
සෙර්පා => ෂෙර්පා
සෙරිෆ් => ෂෙරිෆ්
සෙරීට් => ෂෙරීට්
සෙරෙමෙටෙවේවෝ => ෂෙරෙමෙටෙවේවෝ
සෙහාන් => ෂෙහාන්
සේන් => ෂේන්
සොට්ගන් => ෂොට්ගන්
සෝන් => ෂෝන්
සෝපියන් => ෂෝපියන්
සංක්රමනය => සංක්රමණය
සංක්රමනික => සංක්රමණික
සංක්රමනිකයින් => සංක්රමණිකයින්
සංකිර්න => සංකිර්ණ
සංකිර්නයේ => සංකිර්ණයේ
සංකීර්න => සංකීර්ණ
සංකීර්නයකදී => සංකීර්ණයකදී
සංකීර්නයක් => සංකීර්ණයක්
සංකීර්නයට => සංකීර්ණයට
සංකීර්නයේ => සංකීර්ණයේ
සංකීර්නයේදී => සංකීර්ණයේදී
සංකීර්නයේදීයි => සංකීර්ණයේදීයි
සංක => සංඛ
සංක්යාත => සංඛ්යාත
සංක්යානමය => සංඛ්යානමය
සංක්යාලේකන => සංඛ්යාලේඛන
සංක්යාලේකන => සංඛ්යාලේඛන
සංක්යාව => සංඛ්යාව
සංක්යාවක => සංඛ්යාවක
සංක්යාවකගෙන් => සංඛ්යාවකගෙන්
සංක්යාවකගේ => සංඛ්යාවකගේ
සංක්යාවකට => සංඛ්යාවකට
සංක්යාවක් => සංඛ්යාවක්
සංක්යාවකින් => සංඛ්යාවකින්
සංක්යාවද => සංඛ්යාවද
සංක්යාවයි => සංඛ්යාවයි
සංකේත => සංඛේත
සංකේතය => සංඛේතය
සංකේතවත් => සංඛේතවත්
සංග => සංඝ
සංගනායක => සංඝනායක
සංගයා => සංඝයා
සංගරත්නය => සංඝරත්නය
සංගරත්නයේ => සංඝරත්නයේ
සංදර්සන => සංදර්ශන
සංදේස => සංදේශ
සංදේසයක් => සංදේශයක්
සංදේසයට => සංදේශයට
සංදා => සංධා
සංදානයේ => සංධානයේ
සංරක්සණය => සංරක්ෂණය
සංරක්ෂනය => සංරක්ෂණය
සංවර්දන => සංවර්ධන
සංවර්දනය => සංවර්ධනය
සංවර්දනයක් => සංවර්ධනයක්
සංවර්දනයට => සංවර්ධනයට
සංවර්දනයන් => සංවර්ධනයන්
සංවර්දිත => සංවර්ධිත
සංවිදන => සංවිධන
සංවිදාන => සංවිධාන
සංවිදානය => සංවිධානය
සංවිදානයක => සංවිධානයක
සංවිදානයකට => සංවිධානයකට
සංවිදානයක් => සංවිධානයක්
සංවිදානයකින් => සංවිධානයකින්
සංවිදානයකින්ද => සංවිධානයකින්ද
සංවිදානයට => සංවිධානයට
සංවිදානයද => සංවිධානයද
සංවිදානයන් => සංවිධානයන්
සංවිදානයයි => සංවිධානයයි
සංවිදානය් => සංවිධානය්
සංවිදානයෙන් => සංවිධානයෙන්
සංවිදානයේ => සංවිධානයේ
සංවිදානයේම => සංවිධානයේම
සංවිදානවල => සංවිධානවල
සංවිදානවලට => සංවිධානවලට
සංවිදානවලින් => සංවිධානවලින්
සංවිදානාත්මක => සංවිධානාත්මක
සංවිදායක => සංවිධායක
සංවිදායකයින් => සංවිධායකයින්
සංවිදායකවරුන්ගේ => සංවිධායකවරුන්ගේ
සංසෝදනයට => සංශෝදනයට
සංසෝධන => සංශෝධන
සංශෝදන => සංශෝධන
සංසෝධනය => සංශෝධනය
සංශෝදනය => සංශෝධනය
සංසෝධනයකට => සංශෝධනයකට
සංශෝදනයකට => සංශෝධනයකට
සංසෝධනයක් => සංශෝධනයක්
සංශෝදනයක් => සංශෝධනයක්
සංසෝධනයට => සංශෝධනයට
සංශෝදනයට => සංශෝධනයට
සංසෝධනයත් => සංශෝධනයත්
සංශෝදනයත් => සංශෝධනයත්
සංසෝධනයන් => සංශෝධනයන්
සංශෝදනයන් => සංශෝධනයන්
සංසෝධනයෙන් => සංශෝධනයෙන්
සංශෝදනයෙන් => සංශෝධනයෙන්
සංසෝධනයේ => සංශෝධනයේ
සංශෝදනයේ => සංශෝධනයේ
සංසෝධනයේදි => සංශෝධනයේදි
සංශෝදනයේදි => සංශෝධනයේදි
සංසෝධනයේදී => සංශෝධනයේදී
සංශෝදනයේදී => සංශෝධනයේදී
සංසෝධිත => සංශෝධිත
සංශෝදිත => සංශෝධිත
සංසරනය => සංසරණය
සංස්කරනයත් => සංස්කරණයත්
සංස්තවේ => සංස්ථවේ
සංස්තා => සංස්ථා
සංස්තාව => සංස්ථාව
සංස්තාවට => සංස්ථාවට
සංස්තාවේ => සංස්ථාවේ
සච්චායනයකින් => සඡ්ඡායනයකින්
සච්චායනයකින් => සඡ්ඡායනයකින්
සතිපොල => සතිපොළ
සද්දර්ම => සද්ධර්ම
සන්දේසයක් => සන්දේශයක්
සන්දනායේ => සන්ධනායේ
සන්ද්යා => සන්ධ්යා
සන්ද්යාවක => සන්ධ්යාවක
සන්දාන => සන්ධාන
සන්දානය => සන්ධානය
සන්දානයකට => සන්ධානයකට
සන්දානයක් => සන්ධානයක්
සන්දානයකින් => සන්ධානයකින්
සන්දානයට => සන්ධානයට
සන්දානයෙන් => සන්ධානයෙන්
සන්දානයේ => සන්ධානයේ
සන්දිස්ථානයක් => සන්ධිස්ථානයක්
සන්ධිස්තානයක් => සන්ධිස්ථානයක්
සන්නද්ද => සන්නද්ධ
සනාත => සනාථ
සබවේ => සභවේ
සබා => සභා
සබාකයෙකු => සභාකයෙකු
සබානායක => සභානායක
සබානායකවරයා => සභානායකවරයා
සබාපති => සභාපති
සබාපතිට => සභාපතිට
සබාපතිත්වයෙන් => සභාපතිත්වයෙන්
සබාපතිධූරය => සභාපතිධූරය
සභාපතිදූරය => සභාපතිධූරය
සබාපතිවරයා => සභාපතිවරයා
සබාපතිවරයාගෙන් => සභාපතිවරයාගෙන්
සබාපතිවරයාට => සභාපතිවරයාට
සබාපතිවරයෙකු => සභාපතිවරයෙකු
සබාපතිවරුන් => සභාපතිවරුන්
සබාපතීත්වය => සභාපතීත්වය
සබාමැතිවරණය => සභාමැතිවරණය
සභාමැතිවරනය => සභාමැතිවරණය
සබායි => සභායි
සබාව => සභාව
සබාවක => සභාවක
සබාවක් => සභාවක්
සබාවට => සභාවට
සබාවටම => සභාවටම
සබාවද => සභාවද
සබාවන් => සභාවන්
සබාවල => සභාවල
සබාවලට => සභාවලට
සබාවෙන් => සභාවෙන්
සබාවේ => සභාවේ
සබාවේදි => සභාවේදි
සබාවේදී => සභාවේදී
සබාවේදීයි => සභාවේදීයි
සබික => සභික
සබිකයින් => සභිකයින්
සබිකයෙක් => සභිකයෙක්
සමත්වුනා => සමත්වුණා
සමතයකට => සමථයකට
සමනල => සමනළ
සමබන්ද => සමබන්ධ
සමබන්දයෙන් => සමබන්ධයෙන්
සමයවර්දන => සමයවර්ධන
සමස්ත => සමස්ථ
සමස්තයක් => සමස්ථයක්
සමස්තයම => සමස්ථයම
සම්ප්රේසණ => සම්ප්රේෂණ
සම්ප්රේෂන => සම්ප්රේෂණ
සම්ප්රේසණය => සම්ප්රේෂණය
සම්ප්රේෂනය => සම්ප්රේෂණය
සම්පින්ඩන => සම්පිණ්ඩන
සම්පුර්න => සම්පුර්ණ
සම්පුර්නයෙන්ම => සම්පුර්ණයෙන්ම
සම්පූර්න => සම්පූර්ණ
සම්පූර්නයෙන් => සම්පූර්ණයෙන්
සම්පූර්නයෙන්ම => සම්පූර්ණයෙන්ම
සම්පේ්රසණ => සම්පේ්රෂණ
සම්පේ්රෂන => සම්පේ්රෂණ
සම්බදීකරණය => සම්බධීකරණය
සම්බධීකරනය => සම්බධීකරණය
සම්බන්ද => සම්බන්ධ
සම්බන්දකම් => සම්බන්ධකම්
සම්බන්දටෙන් => සම්බන්ධටෙන්
සම්බන්දතා => සම්බන්ධතා
සම්බන්දතාවක් => සම්බන්ධතාවක්
සම්බන්දතාවය => සම්බන්ධතාවය
සම්බන්දතාවයක් => සම්බන්ධතාවයක්
සම්බන්දදැයි => සම්බන්ධදැයි
සම්බන්දන් => සම්බන්ධන්
සම්බන්දන්ද => සම්බන්ධන්ද
සම්බන්දය => සම්බන්ධය
සම්බන්දයක් => සම්බන්ධයක්
සම්බන්දයන් => සම්බන්ධයන්
සම්බන්දයි => සම්බන්ධයි
සම්බන්දයෙක් => සම්බන්ධයෙක්
සම්බන්දයෙන => සම්බන්ධයෙන
සම්බන්දයෙන් => සම්බන්ධයෙන්
සම්බන්දයෙන්ද => සම්බන්ධයෙන්ද
සම්බන්දයෙනි => සම්බන්ධයෙනි
සම්බන්දයෙනුයි => සම්බන්ධයෙනුයි
සම්බන්දව => සම්බන්ධව
සම්බන්දවී => සම්බන්ධවී
සම්බන්දවීම => සම්බන්ධවීම
සම්බන්දවීමද => සම්බන්ධවීමද
සම්බන්දවුවන්ට => සම්බන්ධවුවන්ට
සම්බන්දවූ => සම්බන්ධවූ
සම්බන්දවේ => සම්බන්ධවේ
සම්බන්දිකරණ => සම්බන්ධිකරණ
සම්බන්ධිකරන => සම්බන්ධිකරණ
සම්බන්දිකාරකත් => සම්බන්ධිකාරකත්
සම්බන්දීකරණ => සම්බන්ධීකරණ
සම්බන්ධීකරන => සම්බන්ධීකරණ
සම්බන්දීකරණය => සම්බන්ධීකරණය
සම්බන්ධීකරනය => සම්බන්ධීකරණය
සම්බන්දීකරණයක් => සම්බන්ධීකරණයක්
සම්බන්ධීකරනයක් => සම්බන්ධීකරණයක්
සම්බන්දීකාරක => සම්බන්ධීකාරක
සම්බන්දීරණයක් => සම්බන්ධීරණයක්
සම්බන්ධීරනයක් => සම්බන්ධීරණයක්
සම්බාදක => සම්බාධක
සම්බුද්ද => සම්බුද්ධ
සම්බුදුරජානන් => සම්බුදුරජාණන්
සම්මන්ත්රන => සම්මන්ත්රණ
සම්මුක => සම්මුඛ
සමාදි => සමාධි
සමාරම්බක => සමාරම්භක
සමීක්සණ => සමීක්ෂණ
සමීක්ෂන => සමීක්ෂණ
සමීක්සණකින් => සමීක්ෂණකින්
සමීක්ෂනකින් => සමීක්ෂණකින්
සමීක්සණය => සමීක්ෂණය
සමීක්ෂනය => සමීක්ෂණය
සමීක්සණයක් => සමීක්ෂණයක්
සමීක්ෂනයක් => සමීක්ෂණයක්
සමීක්සණයට => සමීක්ෂණයට
සමීක්ෂනයට => සමීක්ෂණයට
සමීක්සණයේ => සමීක්ෂණයේ
සමීක්ෂනයේ => සමීක්ෂණයේ
සමීක්සණයේදී => සමීක්ෂණයේදී
සමීක්ෂනයේදී => සමීක්ෂණයේදී
සමුහාන්ඩුවට => සමුහාණ්ඩුවට
සමුලුව => සමුළුව
සමුලුවකට => සමුළුවකට
සමුලුවක් => සමුළුවක්
සමුලුවට => සමුළුවට
සමුලුවෙන් => සමුළුවෙන්
සමුලුවේදී => සමුළුවේදී
සමෘද්දි => සමෘද්ධි
සමෘද්දිමත් => සමෘද්ධිමත්
සමෘද්දිය => සමෘද්ධිය
සමෘද්දිලාභීන් => සමෘද්ධිලාභීන්
සමෘද්ධිලාබීන් => සමෘද්ධිලාභීන්
සරන => සරණ
සරනාගත => සරණාගත
සරනාගතයන් => සරණාගතයන්
සරනාගතයින් => සරණාගතයින්
සරනාගතයෙකු => සරණාගතයෙකු
සලකුන => සලකුණ
සලකුනක් => සලකුණක්
සලකුනත් => සලකුණත්
සලකුනද => සලකුණද
සලකුනු => සලකුණු
සහබාගි => සහභාගි
සහබාගිත්වයෙන් => සහභාගිත්වයෙන්
සහබාගිවන => සහභාගිවන
සහබාගිවන්නේ => සහභාගිවන්නේ
සහබාගිවිම => සහභාගිවිම
සහබාගිවිය => සහභාගිවිය
සහබාගිවී => සහභාගිවී
සහබාගිවීම => සහභාගිවීම
සහබාගිවීමට => සහභාගිවීමට
සහබාගිවීමෙන් => සහභාගිවීමෙන්
සහබාගිවූ => සහභාගිවූ
සහබාගිවෙමින් => සහභාගිවෙමින්
සහබාගී => සහභාගී
සහබාගීත්වයෙන් => සහභාගීත්වයෙන්
සහබාගීවන => සහභාගීවන
සහබාගීවීම => සහභාගීවීම
සහබාගීවීමට => සහභාගීවීමට
සහබාගීවීමෙන් => සහභාගීවීමෙන්
සලකමින් => සළකමින්
සලකා => සළකා
සලකුණු => සළකුණු
සළකුනු => සළකුණු
සලසනු => සළසනු
සලසා => සළසා
ස්කන්ද => ස්කන්ධ
ස්තනය => ස්ථනය
ස්තනායේ => ස්ථනායේ
ස්තාන => ස්ථාන
ස්තානගත => ස්ථානගත
ස්තානගතවී => ස්ථානගතවී
ස්තානය => ස්ථානය
ස්තානයක => ස්ථානයක
ස්තානයකට => ස්ථානයකට
ස්තානයකදි => ස්ථානයකදි
ස්තානයකදීයි => ස්ථානයකදීයි
ස්තානයක් => ස්ථානයක්
ස්තානයට => ස්ථානයට
ස්තානයත් => ස්ථානයත්
ස්තානයද => ස්ථානයද
ස්තානයන් => ස්ථානයන්
ස්තානයයි => ස්ථානයයි
ස්තානයෙන් => ස්ථානයෙන්
ස්තානයේ => ස්ථානයේ
ස්තානයේදී => ස්ථානයේදී
ස්තානයේදීම => ස්ථානයේදීම
ස්තානයේයි => ස්ථානයේයි
ස්තානවල => ස්ථානවල
ස්තානවලට => ස්ථානවලට
ස්තානවලත් => ස්ථානවලත්
ස්තානවලදී => ස්ථානවලදී
ස්තානවලින් => ස්ථානවලින්
ස්තානවලින්ද => ස්ථානවලින්ද
ස්තානාධිපති => ස්ථානාධිපති
ස්ථානාදිපති => ස්ථානාධිපති
ස්තානාධිපතිපවරයා => ස්ථානාධිපතිපවරයා
ස්ථානාදිපතිපවරයා => ස්ථානාධිපතිපවරයා
ස්තානාධිපතිවරයා => ස්ථානාධිපතිවරයා
ස්ථානාදිපතිවරයා => ස්ථානාධිපතිවරයා
ස්තානාධිපතිවරයාගේ => ස්ථානාධිපතිවරයාගේ
ස්ථානාදිපතිවරයාගේ => ස්ථානාධිපතිවරයාගේ
ස්තානාධිපතිවරයාට => ස්ථානාධිපතිවරයාට
ස්ථානාදිපතිවරයාට => ස්ථානාධිපතිවරයාට
ස්තානාධිපතිවරයාටත් => ස්ථානාධිපතිවරයාටත්
ස්ථානාදිපතිවරයාටත් => ස්ථානාධිපතිවරයාටත්
ස්තානාධිපතිවරයාව => ස්ථානාධිපතිවරයාව
ස්ථානාදිපතිවරයාව => ස්ථානාධිපතිවරයාව
ස්තානාධිපතිවරයෙකු => ස්ථානාධිපතිවරයෙකු
ස්ථානාදිපතිවරයෙකු => ස්ථානාධිපතිවරයෙකු
ස්තානාධිපතිවරුන් => ස්ථානාධිපතිවරුන්
ස්ථානාදිපතිවරුන් => ස්ථානාධිපතිවරුන්
ස්තානාධිපතිවරුන්ට => ස්ථානාධිපතිවරුන්ට
ස්ථානාදිපතිවරුන්ට => ස්ථානාධිපතිවරුන්ට
ස්තාපිත => ස්ථාපිත
ස්තාවර => ස්ථාවර
ස්තාවරත්වය => ස්ථාවරත්වය
ස්තාවරය => ස්ථාවරය
ස්තාවරව => ස්ථාවරව
ස්තිර => ස්ථිර
ස්තිරවම => ස්ථිරවම
ස්තීර => ස්ථීර
ස්තීරව => ස්ථීරව
ස්තීරවම => ස්ථීරවම
ස්පර්ස => ස්පර්ශ
ස්වදේස => ස්වදේශ
ස්වදේසිකයන්ට => ස්වදේශිකයන්ට
ස්වබාවය => ස්වභාවය
ස්වබාවයක් => ස්වභාවයක්
ස්වබාවයට => ස්වභාවයට
ස්වබාවික => ස්වභාවික
ස්වර්නතිලක => ස්වර්ණතිලක
ස්වර්නපාලි => ස්වර්ණපාලි
ස්වර්නා => ස්වර්ණා
ස්වර්නාභරන => ස්වර්ණාභරණ
ස්වර්ණාබරණ => ස්වර්ණාභරණ
ස්වර්නාභරන => ස්වර්ණාභරණ
ස්වසක්ති => ස්වශක්ති
ස්වාදින => ස්වාධින
ස්වාදීන => ස්වාධීන
ස්වාදීනත්වයට => ස්වාධීනත්වයට
ස්වාදීනව => ස්වාධීනව
ස්වාබාවිකවම => ස්වාභාවිකවම
ස්වෙච්චා => ස්වෙච්ඡා
ස්වේච්චා => ස්වේච්ඡා
ස්වේච්චාවෙන්ම => ස්වේච්ඡාවෙන්ම
ස්වෛරිබාවය => ස්වෛරිභාවය
ස්වෛරීබාවයට => ස්වෛරීභාවයට
සාකච්චවේදී => සාකච්ඡවේදී
සාකච්චා => සාකච්ඡා
සාකච්චාකදි => සාකච්ඡාකදි
සාකච්චාව => සාකච්ඡාව
සාකච්චාවක => සාකච්ඡාවක
සාකච්චාවකට => සාකච්ඡාවකට
සාකච්චාවකදී => සාකච්ඡාවකදී
සාකච්චාවකදීයි => සාකච්ඡාවකදීයි
සාකච්චාවක් => සාකච්ඡාවක්
සාකච්චාවක්ද => සාකච්ඡාවක්ද
සාකච්චාවකින් => සාකච්ඡාවකින්
සාකච්චාවට => සාකච්ඡාවට
සාකච්චාවද => සාකච්ඡාවද
සාකච්චාවන්ට => සාකච්ඡාවන්ට
සාකච්චාවල => සාකච්ඡාවල
සාකච්චාවලට => සාකච්ඡාවලට
සාකච්චාවලදී => සාකච්ඡාවලදී
සාකච්චාවලින් => සාකච්ඡාවලින්
සාකච්චාවාට => සාකච්ඡාවාට
සාකච්චාවාර => සාකච්ඡාවාර
සාකච්චාවෙන් => සාකච්ඡාවෙන්
සාකච්චාවේ => සාකච්ඡාවේ
සාකච්චාවේදි => සාකච්ඡාවේදි
සාකච්චාවේදී => සාකච්ඡාවේදී
සාකච්චාවේදීද => සාකච්ඡාවේදීද
සාකච්චාවේදීයි => සාකච්ඡාවේදීයි
සාකච්චුා => සාකච්ඡුා
සාකච්චුාව => සාකච්ඡුාව
සාකච්චුාවකට => සාකච්ඡුාවකට
සාකච්චුාවකටද => සාකච්ඡුාවකටද
සාකච්චුාවකදී => සාකච්ඡුාවකදී
සාකච්චුාවක් => සාකච්ඡුාවක්
සාකච්චුාවකින් => සාකච්ඡුාවකින්
සාකච්චුාවට => සාකච්ඡුාවට
සාකච්චුාවෙන් => සාකච්ඡුාවෙන්
සාකච්චුාවේදී => සාකච්ඡුාවේදී
සාක්සරතාවය => සාක්ෂරතාවය
සාක්සාත් => සාක්ෂාත්
සාක්සි => සාක්ෂි
සාක්සිකරුවන් => සාක්ෂිකරුවන්
සාක්සිකරුවන්ට => සාක්ෂිකරුවන්ට
සාක්සියක් => සාක්ෂියක්
සාක්සියට => සාක්ෂියට
සාදක => සාධක
සාදකය => සාධකය
සාදකයක් => සාධකයක්
සාදනය => සාධනය
සාදනීය => සාධනීය
සාදයක් => සාධයක්
සාදාරණ => සාධාරණ
සාධාරන => සාධාරණ
සාදාරණත්වය => සාධාරණත්වය
සාධාරනත්වය => සාධාරණත්වය
සාදාරණය => සාධාරණය
සාධාරනය => සාධාරණය
සාදාරණයක් => සාධාරණයක්
සාධාරනයක් => සාධාරණයක්
සාදාරණව => සාධාරණව
සාධාරනව => සාධාරණව
සාදාරණීය => සාධාරණීය
සාධාරනීය => සාධාරණීය
සාදාරනත්වය => සාධාරනත්වය
සාදු => සාධු
සාදුකාර => සාධුකාර
සාපරාදි => සාපරාධි
සාපරාදී => සාපරාධී
සාප්ක්සව => සාප්ක්ෂව
සාපාරාදි => සාපාරාධි
සාපේක්සව => සාපේක්ෂව
සාමසාකච්චා => සාමසාකච්ඡා
සාමසාදක => සාමසාධක
සාමාන්යාදිකාරි => සාමාන්යාධිකාරි
සාමාන්යාදිකාරී => සාමාන්යාධිකාරී
සාමාන්යාදිකාරීවරයා => සාමාන්යාධිකාරීවරයා
සාර්තක => සාර්ථක
සාර්තකම => සාර්ථකම
සාර්තකයි => සාර්ථකයි
සාර්තකව => සාර්ථකව
සැකපල => සැකපළ
සැඟවුනු => සැඟවුණු
සැනකෙලියක් => සැණකෙලියක්
සැනකෙලියට => සැණකෙලියට
සැනකෙළිය => සැණකෙළිය
සැණකෙලිය => සැණකෙළිය
සැනකෙළියට => සැණකෙළියට
සැණකෙලියට => සැණකෙළියට
සැරසුනු => සැරසුණු
සැරිසරන => සැරිසරණ
සැලසුම්කරන => සැලසුම්කරණ
සැසදුනු => සැසදුණු
සැලකිය => සැළකිය
සැලකිලිමත් => සැළකිලිමත්
සැලසිය => සැළසිය
සැලසුමක් => සැළසුමක්
සැලසුම් => සැළසුම්
සිංදෝනි => සිංදෝණි
සිද්ද => සිද්ධ
සිද්දවෙයි => සිද්ධවෙයි
සිද්දවෙලා => සිද්ධවෙලා
සිද්දස්ථාන => සිද්ධස්ථාන
සිද්ධස්තාන => සිද්ධස්ථාන
සිද්දස්ථානවලට => සිද්ධස්ථානවලට
සිද්ධස්තානවලට => සිද්ධස්ථානවලට
සිද්දාන්තය => සිද්ධාන්තය
සිද්දාර්ථ => සිද්ධාර්ථ
සිද්ධාර්ත => සිද්ධාර්ථ
සිද්දි => සිද්ධි
සිද්දික් => සිද්ධික්
සිද්දින් => සිද්ධින්
සිද්දිය => සිද්ධිය
සිද්දියකට => සිද්ධියකට
සිද්දියකදී => සිද්ධියකදී
සිද්දියක් => සිද්ධියක්
සිද්දියට => සිද්ධියට
සිද්දියත් => සිද්ධියත්
සිද්දියද => සිද්ධියද
සිද්දියෙන් => සිද්ධියෙන්
සිද්දියේ => සිද්ධියේ
සිද්දියේදී => සිද්ධියේදී
සිද්දියේදීද => සිද්ධියේදීද
සිද්දිවලදී => සිද්ධිවලදී
සිද්දිවලින් => සිද්ධිවලින්
සිද්දිස්ථානවලට => සිද්ධිස්ථානවලට
සිද්ධිස්තානවලට => සිද්ධිස්ථානවලට
සිද්දී => සිද්ධී
සිද්දීන් => සිද්ධීන්
සිද්දීන්ට => සිද්ධීන්ට
සිද්දීන්ටද => සිද්ධීන්ටද
සිද්දීන්වල => සිද්ධීන්වල
සිද්දීන්වලට => සිද්ධීන්වලට
සිද්දීන්වලින් => සිද්ධීන්වලින්
සිදුකල => සිදුකළ
සිදුකලද => සිදුකළද
සිදුකලා => සිදුකළා
සිදුකලේ => සිදුකළේ
සිදුකලේද => සිදුකළේද
සිදුකෙරුනු => සිදුකෙරුණු
සිදුනොකල => සිදුනොකළ
සිදුවුනා => සිදුවුණා
සිදුවුනු => සිදුවුණු
සිදුවුනේ => සිදුවුණේ
සිදුවුනේ => සිදුවුණේ
සිබ => සිඹ
සියබලාපිටිය => සියඹලාපිටිය
සියලු => සියළු
සියලුම => සියළුම
සිරබාරයට => සිරභාරයට
සිරිනිවේසාරාමාදිපති => සිරිනිවේසාරාමාධිපති
සිරිවර්දන => සිරිවර්ධන
සිලවර්දන => සිලවර්ධන
සිහිපත්කරන => සිහිපත්කරණ
සීග්රයෙන් => සීඝ්රයෙන්
සුකෝපභෝගි => සුඛෝපභෝගි
සුඛෝපබෝගි => සුඛෝපභෝගි
සුකෝපභෝගී => සුඛෝපභෝගී
සුඛෝපබෝගී => සුඛෝපභෝගී
සුගන්ද => සුගන්ධ
සුදර්මානන්ද => සුධර්මානන්ද
සුදර්මාරාම => සුධර්මාරාම
සුනක => සුනඛ
සුනකයන් => සුනඛයන්
සුනකයන්ද => සුනඛයන්ද
සුනකයා => සුනඛයා
සුනකයින් => සුනඛයින්
සුනකයින්ගේ => සුනඛයින්ගේ
සුනකයින්ද => සුනඛයින්ද
සුනුවිසුනු => සුනුවිසුණු
සුපරික්සාකාරිව => සුපරික්ෂාකාරිව
සුපරික්සාකාරී => සුපරික්ෂාකාරී
සුප්රසිද්ද => සුප්රසිද්ධ
සුබසාදන => සුබසාධන
සුබාසිංෂණ => සුබාශිංෂණ
සුබාශිංසණ => සුබාශිංෂණ
සුබාශිංෂන => සුබාශිංෂණ
සුබෝදි => සුබෝධි
සුබ => සුභ
සුබවාදී => සුභවාදී
සුබසාධනය => සුභසාධනය
සුභසාදනය => සුභසාධනය
සුබාශිංසන => සුභාශිංසන
සුභාසිංසන => සුභාශිංසන
සුමේද => සුමේධ
සුරක්සා => සුරක්ෂා
සුරක්සාව => සුරක්ෂාව
සුරක්සිත => සුරක්ෂිත
සුරක්සිතතාව => සුරක්ෂිතතාව
සුරියබන්ඩාර => සුරියබණ්ඩාර
සුරේස් => සුරේෂ්
සුලක්සණ => සුලක්ෂණ
සුලක්ෂන => සුලක්ෂණ
සුලක්සන => සුලක්ෂන
සුවිසේෂ => සුවිශේෂ
සුවිශේස => සුවිශේෂ
සුවිසේෂි => සුවිශේෂි
සුවිශේසි => සුවිශේෂි
සුවිසේෂී => සුවිශේෂී
සුවිශේසී => සුවිශේෂී
සුස්මා => සුෂ්මා
සුලං => සුළං
සුලගේ => සුළගේ
සුලි => සුළි
සුලු => සුළු
සුලුතර => සුළුතර
සුලුවෙන් => සුළුවෙන්
සූක්සම => සූක්ෂම
සූරියබන්ඩාර => සූරියබණ්ඩාර
සූරියබන්ඩාරගෙන් => සූරියබණ්ඩාරගෙන්
සෙට්ටිකුලම => සෙට්ටිකුළම
සෙබලුන් => සෙබළුන්
සෙවනේ => සෙවණේ
සේනා => සේණා
සේනාංකාදිපතිවරයා => සේනාංකාධිපතිවරයා
සේනාදිනායක => සේනාධිනායක
සේනාදිනායකයා => සේනාධිනායකයා
සේනාදිනායකයාට => සේනාධිනායකයාට
සේනාදිරත්න => සේනාධිරත්න
සේනාදිරාජා => සේනාධිරාජා
සේවයකල => සේවයකළ
සේවාලාබියෙකුට => සේවාලාභියෙකුට
සොබාදහම් => සොභාදහම්
සොබාවය => සොභාවය
සොයාගැනූනු => සොයාගැණූනු
සෝබිත => සෝභිත
සෝමවංස => සෝමවංශ
සෝමවංසට => සෝමවංශට
සෞක්ය => සෞඛ්ය
සෞක්යට => සෞඛ්යට
සෞක්යමය => සෞඛ්යමය
සෞක්යයට => සෞඛ්යයට
හකුලා => හකුළා
හතලිස් => හතළිස්
හත්තිනිය => හත්තිණිය
හදාරන => හදාරණ
හමුවුනා => හමුවුණා
හබා => හඹා
හබාගිය => හඹාගිය
හබායාම => හඹායාම
හර්ස => හර්ෂ
හර්සණ => හර්ෂණ
හර්ෂන => හර්ෂණ
හසීම්ගේ => හශීම්ගේ
හසිම් => හෂිම්
හසිම්ගේ => හෂිම්ගේ
හසිම්ව => හෂිම්ව
හසීම් => හෂීම්
හසීම්ගේ => හෂීම්ගේ
හසීම්ටද => හෂීම්ටද
හසීම්ද => හෂීම්ද
හාලිඇල => හාලිඇළ
හැකිවුනා => හැකිවුණා
හැරුනා => හැරුණා
හැරුනු => හැරුණු
හැරුනේ => හැරුණේ
හැලුනු => හැලුණු
හැලූනා => හැලූණා
හැසිරුනු => හැසිරුණු
හැසිරෙන => හැසිරෙණ
හැලුණා => හැළුණා
හැළුනා => හැළුණා
හැලුණු => හැළුණු
හැළුනු => හැළුණු
හිතලුවක් => හිතළුවක්
හිතෛසී => හිතෛෂී
හින්දුබෞද්ද => හින්දුබෞද්ධ
හින්දුස්තාන් => හින්දුස්ථාන්
හිමාස => හිමාෂ
හිමිපානනන් => හිමිපාණනන්
හිමිපානන් => හිමිපාණන්
හිමිපානන්ගේ => හිමිපාණන්ගේ
හිමිපානන්ද => හිමිපාණන්ද
හිමිවුනා => හිමිවුණා
හිමිවුනේ => හිමිවුණේ
හිරුනි => හිරුණි
හුනු => හුණු
හුනුපිටිය => හුණුපිටිය
හුසාම් => හුෂාම්
හෙට්ටිපොල => හෙට්ටිපොළ
හෙබ් => හෙඹ්
හෙල => හෙළ
හෙලයි => හෙළයි
හෙලා => හෙළා
හෙලි => හෙළි
හෙලිකර => හෙළිකර
හෙලිකරයි => හෙළිකරයි
හෙලිකිරීමත් => හෙළිකිරීමත්
හෙලිදරව් => හෙළිදරව්
හෙලිදරව්වකට => හෙළිදරව්වකට
හෙලිදරව්වක් => හෙළිදරව්වක්
හෙලිපෙහෙලි => හෙළිපෙහෙළි
හෙලිපෙහෙලි => හෙළිපෙහෙළි
හෙලිව => හෙළිව
හෙලිවන => හෙළිවන
හෙලිවි => හෙළිවි
හෙලිවී => හෙළිවී
හෙලිවුණේ => හෙළිවුණේ
හෙළිවුනේ => හෙළිවුණේ
හෙලිවූ => හෙළිවූ
හෙලිවෙයි => හෙළිවෙයි
හෙලිවෙලා => හෙළිවෙලා
හෙලිවේ => හෙළිවේ
හෙලීමට => හෙළීමට
හෙලීවී => හෙළීවී
හෙලුවා => හෙළුවා
හේවාවිතාන => හේවාවිතාණ
හේවාවිතාරන => හේවාවිතාරණ
හේසා => හේෂා
හේසාන් => හේෂාන්
හොබවන => හොඹවන
හොබවා => හොඹවා
හොරන => හොරණ
ලං => ළං
ලංව => ළංව
ලංවී => ළංවී
ලග => ළග
ලගම => ළගම
ලගා => ළගා
ලගාවීමට => ළගාවීමට
ලඟ => ළඟ
ලඟම => ළඟම
ලඟා => ළඟා
ලමයා => ළමයා
ලමයි => ළමයි
ලමයින් => ළමයින්
ලමයින්ගේ => ළමයින්ගේ
ලමයින්ද => ළමයින්ද
ලමයෙක් => ළමයෙක්
ලමයෙකු => ළමයෙකු
ලමා => ළමා
ලමාරක්ෂක => ළමාරක්ෂක
ළමාරක්සක => ළමාරක්ෂක
ලමාහේවා => ළමාහේවා
ලමුන් => ළමුන්
ලමුන්ගේ => ළමුන්ගේ
ලමුන්ට => ළමුන්ට
ලහිරු => ළහිරු
ලිං => ළිං
ලුණු => ළුණු
ළුනු => ළුණු
ෆයිනෑන්සල් => ෆයිනෑන්ෂල්
